Country,ISO,Region,Date,Aircraft_type,Seats_arrivals_domestic,Seats_arrivals_interregional,Seats_arrivals_intraregional,Seats_arrivals_intl,Seats_arrivals_total,Available_seat_kilometers,Number_of_flights_domestic,Number_of_flights_interregional,Number_of_flights_intraregional,Number_of_flights_intl,Number_of_flights_total
Fiji,FJ,East Asia & Pacific,2019-01-01,passenger,839,273,3480,3753,4592,14304160.248900514,8,1,10,11,19
Fiji,FJ,East Asia & Pacific,2019-01-02,passenger,974,313,3471,3784,4758,14956096.89564508,8,1,10,11,19
Fiji,FJ,East Asia & Pacific,2019-01-03,passenger,1190,443,3675,4118,5308,15921434.568735164,10,2,12,14,24
Fiji,FJ,East Asia & Pacific,2019-01-04,passenger,831,586,3159,3745,4576,14573341.711448403,7,2,12,14,21
Fiji,FJ,East Asia & Pacific,2019-01-05,passenger,744,273,4746,5019,5763,17715468.935881846,7,1,12,13,20
Fiji,FJ,East Asia & Pacific,2019-01-06,passenger,763,750,4482,5232,5995,21796187.48369559,7,3,15,18,25
Fiji,FJ,East Asia & Pacific,2019-01-07,passenger,787,273,3517,3790,4577,14914486.709381998,11,1,12,13,24
Fiji,FJ,East Asia & Pacific,2019-01-08,passenger,707,273,3918,4191,4898,14943288.726948392,9,1,13,14,23
Fiji,FJ,East Asia & Pacific,2019-01-09,passenger,838,586,3126,3712,4550,14849003.504635593,9,2,9,11,20
Fiji,FJ,East Asia & Pacific,2019-01-10,passenger,1111,273,3703,3976,5087,15220337.086924672,12,1,13,14,26
Fiji,FJ,East Asia & Pacific,2019-01-11,passenger,570,586,2469,3055,3625,12893797.80659526,8,2,11,13,21
Fiji,FJ,East Asia & Pacific,2019-01-12,passenger,771,273,5039,5312,6083,18476565.819290794,7,1,13,14,21
Fiji,FJ,East Asia & Pacific,2019-01-13,passenger,950,756,4067,4823,5773,20888381.140626956,9,3,14,17,26
Fiji,FJ,East Asia & Pacific,2019-01-14,passenger,784,273,3294,3567,4351,12639575.504460162,8,1,12,13,21
Fiji,FJ,East Asia & Pacific,2019-01-15,passenger,708,273,3517,3790,4498,15740553.267904256,8,1,11,12,20
Fiji,FJ,East Asia & Pacific,2019-01-16,passenger,860,586,2856,3442,4302,14195348.04036164,6,2,10,12,18
Fiji,FJ,East Asia & Pacific,2019-01-17,passenger,991,273,3487,3760,4751,14509770.027198603,8,1,13,14,22
Fiji,FJ,East Asia & Pacific,2019-01-18,passenger,844,586,3511,4097,4941,17107150.487464234,11,2,13,15,26
Fiji,FJ,East Asia & Pacific,2019-01-19,passenger,885,273,5301,5574,6459,19157091.271579307,10,1,13,14,24
Fiji,FJ,East Asia & Pacific,2019-01-20,passenger,923,756,3335,4091,5014,19138631.454808738,9,3,13,16,25
Fiji,FJ,East Asia & Pacific,2019-01-21,passenger,784,273,3812,4085,4869,15330126.368266106,9,1,12,13,22
Fiji,FJ,East Asia & Pacific,2019-01-22,passenger,691,273,3306,3579,4270,13865448.431246597,9,1,11,12,21
Fiji,FJ,East Asia & Pacific,2019-01-23,passenger,1023,586,2772,3358,4381,14037548.499141576,10,2,9,11,21
Fiji,FJ,East Asia & Pacific,2019-01-24,passenger,1187,273,3517,3790,4977,14618195.431449898,12,1,13,14,26
Fiji,FJ,East Asia & Pacific,2019-01-25,passenger,966,567,3320,3887,4853,14593583.523282843,13,2,12,14,27
Fiji,FJ,East Asia & Pacific,2019-01-26,passenger,730,273,4040,4313,5043,15781434.195489738,10,1,13,14,24
Fiji,FJ,East Asia & Pacific,2019-01-27,passenger,972,756,3437,4193,5165,17395556.878006134,10,3,14,17,27
Fiji,FJ,East Asia & Pacific,2019-01-28,passenger,605,273,3485,3758,4363,14808696.993555304,8,1,13,14,22
Fiji,FJ,East Asia & Pacific,2019-01-29,passenger,759,273,2856,3129,3888,12297151.085289557,11,1,11,12,23
Fiji,FJ,East Asia & Pacific,2019-01-30,passenger,1023,313,2468,2781,3804,10987032.142632399,10,1,10,11,21
Fiji,FJ,East Asia & Pacific,2019-01-31,passenger,1206,273,3282,3555,4761,13681212.846750678,11,1,13,14,25
Fiji,FJ,East Asia & Pacific,2019-02-01,passenger,1027,546,3313,3859,4886,16166780.815771475,11,2,11,13,24
Fiji,FJ,East Asia & Pacific,2019-02-02,passenger,1002,273,3534,3807,4809,15981439.972388767,10,1,13,14,24
Fiji,FJ,East Asia & Pacific,2019-02-03,passenger,1072,756,3623,4379,5451,19277119.57604042,7,3,15,18,25
Fiji,FJ,East Asia & Pacific,2019-02-04,passenger,814,273,2952,3225,4039,12773677.985039702,9,1,10,11,20
Fiji,FJ,East Asia & Pacific,2019-02-05,passenger,781,0,2142,2142,2923,7245655.891114704,9,0,9,9,18
Fiji,FJ,East Asia & Pacific,2019-02-06,passenger,1001,273,2431,2704,3705,10328247.861498257,10,1,8,9,19
Fiji,FJ,East Asia & Pacific,2019-02-07,passenger,1200,273,2787,3060,4260,14203528.859429734,12,1,12,13,25
Fiji,FJ,East Asia & Pacific,2019-02-08,passenger,871,313,3186,3499,4370,13343423.738858648,11,1,10,11,22
Fiji,FJ,East Asia & Pacific,2019-02-09,passenger,939,273,3280,3553,4492,13921954.51814596,10,1,12,13,23
Fiji,FJ,East Asia & Pacific,2019-02-10,passenger,1216,756,3408,4164,5380,17668225.79366905,10,3,13,16,26
Fiji,FJ,East Asia & Pacific,2019-02-11,passenger,841,273,2870,3143,3984,12249997.686520195,11,1,11,12,23
Fiji,FJ,East Asia & Pacific,2019-02-12,passenger,822,273,2411,2684,3506,11532979.432465939,9,1,8,9,18
Fiji,FJ,East Asia & Pacific,2019-02-13,passenger,993,0,2386,2386,3379,9568050.262726853,8,0,9,9,17
Fiji,FJ,East Asia & Pacific,2019-02-14,passenger,1138,273,2933,3206,4344,13820494.026981343,13,1,13,14,27
Fiji,FJ,East Asia & Pacific,2019-02-15,passenger,852,586,2864,3450,4302,13450059.3702018,8,2,10,12,20
Fiji,FJ,East Asia & Pacific,2019-02-16,passenger,996,273,3158,3431,4427,13660913.087589834,10,1,12,13,23
Fiji,FJ,East Asia & Pacific,2019-02-17,passenger,1132,756,3573,4329,5461,19258266.260848194,9,3,14,17,26
Fiji,FJ,East Asia & Pacific,2019-02-18,passenger,834,273,2550,2823,3657,11885815.627039969,8,1,10,11,19
Fiji,FJ,East Asia & Pacific,2019-02-19,passenger,553,273,2163,2436,2989,9536111.80386362,8,1,8,9,17
Fiji,FJ,East Asia & Pacific,2019-02-20,cargo,0,0,0,0,0,0,0,0,1,1,1
Fiji,FJ,East Asia & Pacific,2019-02-20,passenger,811,313,1854,2167,2978,7672829.224592998,9,1,7,8,17
Fiji,FJ,East Asia & Pacific,2019-02-21,cargo,0,0,0,0,0,0,0,0,1,1,1
Fiji,FJ,East Asia & Pacific,2019-02-21,passenger,923,273,2071,2344,3267,10664392.752044994,11,1,10,11,22
Fiji,FJ,East Asia & Pacific,2019-02-22,cargo,0,0,0,0,0,0,0,1,0,1,1
Fiji,FJ,East Asia & Pacific,2019-02-22,passenger,586,0,2851,2851,3437,8205491.6653758865,8,0,10,10,18
Fiji,FJ,East Asia & Pacific,2019-02-23,cargo,0,0,0,0,0,0,0,0,1,1,1
Fiji,FJ,East Asia & Pacific,2019-02-23,passenger,899,273,3031,3304,4203,11568613.968487542,10,1,12,13,23
Fiji,FJ,East Asia & Pacific,2019-02-24,cargo,0,0,0,0,0,0,0,0,1,1,1
Fiji,FJ,East Asia & Pacific,2019-02-24,passenger,858,737,2950,3687,4545,14933343.808338212,9,3,12,15,24
Fiji,FJ,East Asia & Pacific,2019-02-25,cargo,0,0,0,0,0,0,0,0,1,1,1
Fiji,FJ,East Asia & Pacific,2019-02-25,passenger,736,273,2092,2365,3101,10609756.924685273,8,1,10,11,19
Fiji,FJ,East Asia & Pacific,2019-02-26,cargo,0,0,0,0,0,0,0,1,0,1,1
Fiji,FJ,East Asia & Pacific,2019-02-26,passenger,842,0,2659,2659,3501,9981103.660999741,9,0,9,9,18
Fiji,FJ,East Asia & Pacific,2019-02-27,cargo,0,0,0,0,0,0,0,0,1,1,1
Fiji,FJ,East Asia & Pacific,2019-02-27,passenger,1058,313,1749,2062,3120,9144530.148900583,9,1,7,8,17
Fiji,FJ,East Asia & Pacific,2019-02-28,cargo,0,0,0,0,0,0,0,1,0,1,1
Fiji,FJ,East Asia & Pacific,2019-02-28,passenger,940,0,3026,3026,3966,10276769.243318267,10,0,12,12,22
Fiji,FJ,East Asia & Pacific,2019-03-01,cargo,0,0,0,0,0,0,0,0,1,1,1
Fiji,FJ,East Asia & Pacific,2019-03-01,passenger,787,586,2603,3189,3976,12622398.661788043,10,2,10,12,22
Fiji,FJ,East Asia & Pacific,2019-03-02,cargo,0,0,0,0,0,0,0,1,0,1,1
Fiji,FJ,East Asia & Pacific,2019-03-02,passenger,1140,0,3242,3242,4382,11441686.879274165,12,0,12,12,24
Fiji,FJ,East Asia & Pacific,2019-03-03,cargo,0,0,0,0,0,0,0,0,1,1,1
Fiji,FJ,East Asia & Pacific,2019-03-03,passenger,1311,737,2762,3499,4810,15768659.175243603,10,3,12,15,25
Fiji,FJ,East Asia & Pacific,2019-03-04,cargo,0,0,0,0,0,0,0,1,0,1,1
Fiji,FJ,East Asia & Pacific,2019-03-04,passenger,841,0,2638,2638,3479,9736869.669211388,10,0,10,10,20
Fiji,FJ,East Asia & Pacific,2019-03-05,passenger,678,273,2328,2601,3279,11261659.128222346,8,1,9,10,18
Fiji,FJ,East Asia & Pacific,2019-03-06,cargo,0,0,0,0,0,0,0,0,1,1,1
Fiji,FJ,East Asia & Pacific,2019-03-06,passenger,1192,313,1598,1911,3103,6840051.1217197245,9,1,7,8,17
Fiji,FJ,East Asia & Pacific,2019-03-07,cargo,0,0,0,0,0,0,0,0,1,1,1
Fiji,FJ,East Asia & Pacific,2019-03-07,passenger,619,273,2285,2558,3177,9529186.542210793,10,1,11,12,22
Fiji,FJ,East Asia & Pacific,2019-03-08,cargo,0,0,0,0,0,0,0,1,0,1,1
Fiji,FJ,East Asia & Pacific,2019-03-08,passenger,711,313,2857,3170,3881,11015454.235262105,9,1,10,11,20
Fiji,FJ,East Asia & Pacific,2019-03-09,cargo,0,0,0,0,0,0,0,0,1,1,1
Fiji,FJ,East Asia & Pacific,2019-03-09,passenger,980,273,2969,3242,4222,11598271.557178542,8,1,11,12,20
Fiji,FJ,East Asia & Pacific,2019-03-10,cargo,0,0,0,0,0,0,0,0,1,1,1
Fiji,FJ,East Asia & Pacific,2019-03-10,passenger,1050,737,2976,3713,4763,16291608.686790034,9,3,14,17,26
Fiji,FJ,East Asia & Pacific,2019-03-11,cargo,0,0,0,0,0,0,0,1,0,1,1
Fiji,FJ,East Asia & Pacific,2019-03-11,passenger,548,0,2257,2257,2805,7061895.844350774,9,0,8,8,17
Fiji,FJ,East Asia & Pacific,2019-03-12,passenger,727,273,2206,2479,3206,10923577.19207721,10,1,8,9,19
Fiji,FJ,East Asia & Pacific,2019-03-13,cargo,0,0,0,0,0,0,0,1,0,1,1
Fiji,FJ,East Asia & Pacific,2019-03-13,passenger,874,0,2274,2274,3148,7362397.216003021,9,0,8,8,17
Fiji,FJ,East Asia & Pacific,2019-03-14,cargo,0,0,0,0,0,0,0,0,2,2,2
Fiji,FJ,East Asia & Pacific,2019-03-14,passenger,774,254,1857,2111,2885,8384744.453095567,11,1,9,10,21
Fiji,FJ,East Asia & Pacific,2019-03-15,cargo,0,0,0,0,0,0,0,0,1,1,1
Fiji,FJ,East Asia & Pacific,2019-03-15,passenger,785,586,3040,3626,4411,13703698.885155808,10,2,10,12,22
Fiji,FJ,East Asia & Pacific,2019-03-16,cargo,0,0,0,0,0,0,0,1,0,1,1
Fiji,FJ,East Asia & Pacific,2019-03-16,passenger,828,0,3202,3202,4030,11269050.956292614,9,0,13,13,22
Fiji,FJ,East Asia & Pacific,2019-03-17,cargo,0,0,0,0,0,0,0,0,1,1,1
Fiji,FJ,East Asia & Pacific,2019-03-17,passenger,760,689,2578,3267,4027,14605790.004864234,10,3,10,13,23
Fiji,FJ,East Asia & Pacific,2019-03-18,cargo,0,0,0,0,0,0,0,0,1,1,1
Fiji,FJ,East Asia & Pacific,2019-03-18,passenger,616,273,2393,2666,3282,11634905.536995027,9,1,9,10,19
Fiji,FJ,East Asia & Pacific,2019-03-19,cargo,0,0,0,0,0,0,0,1,0,1,1
Fiji,FJ,East Asia & Pacific,2019-03-19,passenger,795,0,2684,2684,3479,9679480.439370092,10,0,9,9,19
Fiji,FJ,East Asia & Pacific,2019-03-20,cargo,0,0,0,0,0,0,0,0,1,1,1
Fiji,FJ,East Asia & Pacific,2019-03-20,passenger,871,313,2273,2586,3457,8906750.799071563,8,1,9,10,18
Fiji,FJ,East Asia & Pacific,2019-03-21,passenger,1000,273,2769,3042,4042,11998600.84221639,13,1,12,13,26
Fiji,FJ,East Asia & Pacific,2019-03-22,cargo,0,0,0,0,0,0,0,1,0,1,1
Fiji,FJ,East Asia & Pacific,2019-03-22,passenger,708,313,2532,2845,3553,10648074.39705041,11,1,9,10,21
Fiji,FJ,East Asia & Pacific,2019-03-23,cargo,0,0,0,0,0,0,0,0,1,1,1
Fiji,FJ,East Asia & Pacific,2019-03-23,passenger,600,273,2881,3154,3754,9940632.876912536,9,1,12,13,22
Fiji,FJ,East Asia & Pacific,2019-03-24,cargo,0,0,0,0,0,0,0,0,1,1,1
Fiji,FJ,East Asia & Pacific,2019-03-24,passenger,790,731,3564,4295,5085,19111512.76356972,6,3,13,16,22
Fiji,FJ,East Asia & Pacific,2019-03-25,cargo,0,0,0,0,0,0,0,1,0,1,1
Fiji,FJ,East Asia & Pacific,2019-03-25,passenger,720,0,2907,2907,3627,10904440.203605726,8,0,10,10,18
Fiji,FJ,East Asia & Pacific,2019-03-26,cargo,0,0,0,0,0,0,0,0,1,1,1
Fiji,FJ,East Asia & Pacific,2019-03-26,passenger,339,273,2117,2390,2729,10983352.452118205,4,1,7,8,12
Fiji,FJ,East Asia & Pacific,2019-03-27,cargo,0,0,0,0,0,0,0,0,1,1,1
Fiji,FJ,East Asia & Pacific,2019-03-27,passenger,608,313,2149,2462,3070,9827954.650260031,5,1,9,10,15
Fiji,FJ,East Asia & Pacific,2019-03-28,cargo,0,0,0,0,0,0,0,0,1,1,1
Fiji,FJ,East Asia & Pacific,2019-03-28,passenger,448,273,2474,2747,3195,11733783.293047007,6,1,10,11,17
Fiji,FJ,East Asia & Pacific,2019-03-29,cargo,0,0,0,0,0,0,0,1,0,1,1
Fiji,FJ,East Asia & Pacific,2019-03-29,passenger,361,313,2690,3003,3364,10967670.763764482,4,1,8,9,13
Fiji,FJ,East Asia & Pacific,2019-03-30,cargo,0,0,0,0,0,0,0,0,3,3,3
Fiji,FJ,East Asia & Pacific,2019-03-30,passenger,611,273,2919,3192,3803,11679717.28240384,6,1,11,12,18
Fiji,FJ,East Asia & Pacific,2019-03-31,cargo,0,0,0,0,0,0,0,1,1,2,2
Fiji,FJ,East Asia & Pacific,2019-03-31,passenger,437,477,3536,4013,4450,14276015.908631848,4,2,10,12,16
Fiji,FJ,East Asia & Pacific,2019-04-01,cargo,0,0,0,0,0,0,0,0,2,2,2
Fiji,FJ,East Asia & Pacific,2019-04-01,passenger,424,273,3053,3326,3750,11707587.136716109,4,1,11,12,16
Fiji,FJ,East Asia & Pacific,2019-04-02,cargo,0,0,0,0,0,0,0,1,0,1,1
Fiji,FJ,East Asia & Pacific,2019-04-02,passenger,293,0,2920,2920,3213,10844095.601449657,4,0,7,7,11
Fiji,FJ,East Asia & Pacific,2019-04-03,cargo,0,0,0,0,0,0,0,1,1,2,2
Fiji,FJ,East Asia & Pacific,2019-04-03,passenger,396,313,2287,2600,2996,10592292.004486794,4,1,10,11,15
Fiji,FJ,East Asia & Pacific,2019-04-04,cargo,0,0,0,0,0,0,0,1,1,2,2
Fiji,FJ,East Asia & Pacific,2019-04-04,passenger,364,0,3476,3476,3840,10592516.567468505,5,0,8,8,13
Fiji,FJ,East Asia & Pacific,2019-04-05,cargo,0,0,0,0,0,0,0,0,1,1,1
Fiji,FJ,East Asia & Pacific,2019-04-05,passenger,282,586,2955,3541,3823,14142369.491169056,4,2,10,12,16
Fiji,FJ,East Asia & Pacific,2019-04-06,cargo,0,0,0,0,0,0,0,1,1,2,2
Fiji,FJ,East Asia & Pacific,2019-04-06,passenger,428,0,3612,3612,4040,12697065.279313505,5,0,11,11,16
Fiji,FJ,East Asia & Pacific,2019-04-07,cargo,0,0,0,0,0,0,0,1,1,2,2
Fiji,FJ,East Asia & Pacific,2019-04-07,passenger,478,477,3786,4263,4741,16420113.712202324,4,2,14,16,20
Fiji,FJ,East Asia & Pacific,2019-04-08,cargo,0,0,0,0,0,0,0,1,1,2,2
Fiji,FJ,East Asia & Pacific,2019-04-08,passenger,404,0,3665,3665,4069,12759061.925090414,5,0,12,12,17
Fiji,FJ,East Asia & Pacific,2019-04-09,cargo,0,0,0,0,0,0,0,1,1,2,2
Fiji,FJ,East Asia & Pacific,2019-04-09,passenger,312,0,2653,2653,2965,10090928.161874363,4,0,8,8,12
Fiji,FJ,East Asia & Pacific,2019-04-10,cargo,0,0,0,0,0,0,0,0,2,2,2
Fiji,FJ,East Asia & Pacific,2019-04-10,passenger,410,586,2841,3427,3837,13683684.494417373,4,2,10,12,16
Fiji,FJ,East Asia & Pacific,2019-04-11,cargo,0,0,0,0,0,0,0,1,0,1,1
Fiji,FJ,East Asia & Pacific,2019-04-11,passenger,345,0,825,825,1170,4905384.212067333,5,0,4,4,9
Fiji,FJ,East Asia & Pacific,2019-04-12,cargo,0,0,0,0,0,0,0,1,1,2,2
Fiji,FJ,East Asia & Pacific,2019-04-12,passenger,38,313,4785,5098,5136,16177229.54684074,1,1,13,14,15
Fiji,FJ,East Asia & Pacific,2019-04-13,cargo,0,0,0,0,0,0,0,1,1,2,2
Fiji,FJ,East Asia & Pacific,2019-04-13,passenger,0,0,3157,3157,3157,9865971.469812108,0,0,10,10,10
Fiji,FJ,East Asia & Pacific,2019-04-14,cargo,0,0,0,0,0,0,0,0,2,2,2
Fiji,FJ,East Asia & Pacific,2019-04-14,passenger,277,750,3927,4677,4954,17640762.803047307,4,3,11,14,18
Fiji,FJ,East Asia & Pacific,2019-04-15,cargo,0,0,0,0,0,0,0,1,1,2,2
Fiji,FJ,East Asia & Pacific,2019-04-15,passenger,38,0,3494,3494,3532,12266572.804882828,2,0,10,10,12
Fiji,FJ,East Asia & Pacific,2019-04-16,cargo,0,0,0,0,0,0,0,0,1,1,1
Fiji,FJ,East Asia & Pacific,2019-04-16,passenger,57,273,3225,3498,3555,13435267.953908278,2,1,8,9,11
Fiji,FJ,East Asia & Pacific,2019-04-17,cargo,0,0,0,0,0,0,0,1,1,2,2
Fiji,FJ,East Asia & Pacific,2019-04-17,passenger,239,313,2851,3164,3403,11870306.554220783,3,1,10,11,14
Fiji,FJ,East Asia & Pacific,2019-04-18,cargo,0,0,0,0,0,0,0,1,1,2,2
Fiji,FJ,East Asia & Pacific,2019-04-18,passenger,364,0,3813,3813,4177,11225655.62071615,6,0,8,8,14
Fiji,FJ,East Asia & Pacific,2019-04-19,cargo,0,0,0,0,0,0,0,0,2,2,2
Fiji,FJ,East Asia & Pacific,2019-04-19,passenger,364,586,3335,3921,4285,15589066.632987013,4,2,9,11,15
Fiji,FJ,East Asia & Pacific,2019-04-20,cargo,0,0,0,0,0,0,0,1,1,2,2
Fiji,FJ,East Asia & Pacific,2019-04-20,passenger,383,0,3847,3847,4230,13647837.43369072,5,0,11,11,16
Fiji,FJ,East Asia & Pacific,2019-04-21,cargo,0,0,0,0,0,0,0,1,1,2,2
Fiji,FJ,East Asia & Pacific,2019-04-21,passenger,421,477,3984,4461,4882,15438636.413044002,2,2,12,14,16
Fiji,FJ,East Asia & Pacific,2019-04-22,cargo,0,0,0,0,0,0,0,0,3,3,3
Fiji,FJ,East Asia & Pacific,2019-04-22,passenger,255,273,3357,3630,3885,12095557.869347826,3,1,10,11,14
Fiji,FJ,East Asia & Pacific,2019-04-23,cargo,0,0,0,0,0,0,0,1,1,2,2
Fiji,FJ,East Asia & Pacific,2019-04-23,passenger,467,0,3372,3372,3839,11780994.513912763,6,0,8,8,14
Fiji,FJ,East Asia & Pacific,2019-04-24,cargo,0,0,0,0,0,0,0,0,2,2,2
Fiji,FJ,East Asia & Pacific,2019-04-24,passenger,622,586,2417,3003,3625,11409724.333565023,5,2,9,11,16
Fiji,FJ,East Asia & Pacific,2019-04-25,cargo,0,0,0,0,0,0,0,1,1,2,2
Fiji,FJ,East Asia & Pacific,2019-04-25,passenger,486,0,3522,3522,4008,12327104.360853616,6,0,10,10,16
Fiji,FJ,East Asia & Pacific,2019-04-26,cargo,0,0,0,0,0,0,0,1,1,2,2
Fiji,FJ,East Asia & Pacific,2019-04-26,passenger,445,254,3671,3925,4370,13185441.563558947,5,1,10,11,16
Fiji,FJ,East Asia & Pacific,2019-04-27,cargo,0,0,0,0,0,0,0,1,1,2,2
Fiji,FJ,East Asia & Pacific,2019-04-27,passenger,372,0,3897,3897,4269,11626735.667808387,4,0,10,10,14
Fiji,FJ,East Asia & Pacific,2019-04-28,cargo,0,0,0,0,0,0,0,0,2,2,2
Fiji,FJ,East Asia & Pacific,2019-04-28,passenger,467,691,3972,4663,5130,19478017.048395447,5,3,13,16,21
Fiji,FJ,East Asia & Pacific,2019-04-29,cargo,0,0,0,0,0,0,0,1,2,3,3
Fiji,FJ,East Asia & Pacific,2019-04-29,passenger,426,0,3377,3377,3803,9703729.504028257,5,0,11,11,16
Fiji,FJ,East Asia & Pacific,2019-04-30,cargo,0,0,0,0,0,0,0,0,1,1,1
Fiji,FJ,East Asia & Pacific,2019-04-30,passenger,396,273,2236,2509,2905,11724330.96929335,5,1,7,8,13
Fiji,FJ,East Asia & Pacific,2019-05-01,cargo,0,0,0,0,0,0,0,2,0,2,2
Fiji,FJ,East Asia & Pacific,2019-05-01,passenger,654,0,2301,2301,2955,7684104.254490405,5,0,9,9,14
Fiji,FJ,East Asia & Pacific,2019-05-02,cargo,0,0,0,0,0,0,0,0,2,2,2
Fiji,FJ,East Asia & Pacific,2019-05-02,passenger,807,254,3044,3298,4105,13599770.190219333,7,1,8,9,16
Fiji,FJ,East Asia & Pacific,2019-05-03,cargo,0,0,0,0,0,0,0,1,1,2,2
Fiji,FJ,East Asia & Pacific,2019-05-03,passenger,372,313,3599,3912,4284,13166453.897032937,4,1,10,11,15
Fiji,FJ,East Asia & Pacific,2019-05-04,cargo,0,0,0,0,0,0,0,1,0,1,1
Fiji,FJ,East Asia & Pacific,2019-05-04,passenger,532,0,2934,2934,3466,11043627.7846639,8,0,10,10,18
Fiji,FJ,East Asia & Pacific,2019-05-05,cargo,0,0,0,0,0,0,0,1,1,2,2
Fiji,FJ,East Asia & Pacific,2019-05-05,passenger,738,477,3899,4376,5114,18289415.577981807,5,2,14,16,21
Fiji,FJ,East Asia & Pacific,2019-05-06,cargo,0,0,0,0,0,0,0,0,2,2,2
Fiji,FJ,East Asia & Pacific,2019-05-06,passenger,689,273,3067,3340,4029,13200749.137199702,7,1,12,13,20
Fiji,FJ,East Asia & Pacific,2019-05-07,cargo,0,0,0,0,0,0,0,1,0,1,1
Fiji,FJ,East Asia & Pacific,2019-05-07,passenger,534,0,2777,2777,3311,10250533.887838103,5,0,8,8,13
Fiji,FJ,East Asia & Pacific,2019-05-08,cargo,0,0,0,0,0,0,0,1,1,2,2
Fiji,FJ,East Asia & Pacific,2019-05-08,passenger,757,313,2243,2556,3313,10256544.954622284,6,1,9,10,16
Fiji,FJ,East Asia & Pacific,2019-05-09,cargo,0,0,0,0,0,0,0,1,1,2,2
Fiji,FJ,East Asia & Pacific,2019-05-09,passenger,502,0,3205,3205,3707,9862074.270363804,8,0,8,8,16
Fiji,FJ,East Asia & Pacific,2019-05-10,cargo,0,0,0,0,0,0,0,0,1,1,1
Fiji,FJ,East Asia & Pacific,2019-05-10,passenger,84,586,3305,3891,3975,14332464.530019727,2,2,10,12,14
Fiji,FJ,East Asia & Pacific,2019-05-11,cargo,0,0,0,0,0,0,0,1,0,1,1
Fiji,FJ,East Asia & Pacific,2019-05-11,passenger,0,0,4084,4084,4084,13634939.903762445,0,0,13,13,13
Fiji,FJ,East Asia & Pacific,2019-05-12,cargo,0,0,0,0,0,0,0,1,1,2,2
Fiji,FJ,East Asia & Pacific,2019-05-12,passenger,540,424,2449,2873,3413,10681228.862725142,5,2,12,14,19
Fiji,FJ,East Asia & Pacific,2019-05-13,cargo,0,0,0,0,0,0,0,0,2,2,2
Fiji,FJ,East Asia & Pacific,2019-05-13,passenger,624,273,2814,3087,3711,10987588.344403801,7,1,11,12,19
Fiji,FJ,East Asia & Pacific,2019-05-14,cargo,0,0,0,0,0,0,0,1,0,1,1
Fiji,FJ,East Asia & Pacific,2019-05-14,passenger,564,0,2647,2647,3211,9933317.14127683,5,0,8,8,13
Fiji,FJ,East Asia & Pacific,2019-05-15,cargo,0,0,0,0,0,0,0,0,2,2,2
Fiji,FJ,East Asia & Pacific,2019-05-15,passenger,716,527,1791,2318,3034,9330375.394875959,5,2,8,10,15
Fiji,FJ,East Asia & Pacific,2019-05-16,cargo,0,0,0,0,0,0,0,1,1,2,2
Fiji,FJ,East Asia & Pacific,2019-05-16,passenger,725,0,2941,2941,3666,10460191.825021701,7,0,9,9,16
Fiji,FJ,East Asia & Pacific,2019-05-17,cargo,0,0,0,0,0,0,0,1,1,2,2
Fiji,FJ,East Asia & Pacific,2019-05-17,passenger,692,254,2834,3088,3780,10696620.702890739,7,1,9,10,17
Fiji,FJ,East Asia & Pacific,2019-05-18,cargo,0,0,0,0,0,0,0,0,2,2,2
Fiji,FJ,East Asia & Pacific,2019-05-18,passenger,730,273,3190,3463,4193,12175843.421154547,6,1,10,11,17
Fiji,FJ,East Asia & Pacific,2019-05-19,cargo,0,0,0,0,0,0,0,1,1,2,2
Fiji,FJ,East Asia & Pacific,2019-05-19,passenger,722,418,3145,3563,4285,12467096.045259822,6,2,13,15,21
Fiji,FJ,East Asia & Pacific,2019-05-20,cargo,0,0,0,0,0,0,0,1,1,2,2
Fiji,FJ,East Asia & Pacific,2019-05-20,passenger,684,0,3194,3194,3878,9490478.989396054,7,0,11,11,18
Fiji,FJ,East Asia & Pacific,2019-05-21,cargo,0,0,0,0,0,0,0,0,1,1,1
Fiji,FJ,East Asia & Pacific,2019-05-21,passenger,510,273,2452,2725,3235,11587866.462739123,6,1,8,9,15
Fiji,FJ,East Asia & Pacific,2019-05-22,cargo,0,0,0,0,0,0,0,1,1,2,2
Fiji,FJ,East Asia & Pacific,2019-05-22,passenger,833,254,1903,2157,2990,7331599.48150713,6,1,8,9,15
Fiji,FJ,East Asia & Pacific,2019-05-23,cargo,0,0,0,0,0,0,0,1,1,2,2
Fiji,FJ,East Asia & Pacific,2019-05-23,passenger,785,0,3027,3027,3812,10743594.147701204,7,0,9,9,16
Fiji,FJ,East Asia & Pacific,2019-05-24,cargo,0,0,0,0,0,0,0,1,1,2,2
Fiji,FJ,East Asia & Pacific,2019-05-24,passenger,600,254,3466,3720,4320,13696652.660769716,5,1,10,11,16
Fiji,FJ,East Asia & Pacific,2019-05-25,cargo,0,0,0,0,0,0,0,1,1,2,2
Fiji,FJ,East Asia & Pacific,2019-05-25,passenger,796,0,3471,3471,4267,10698091.98449609,6,0,10,10,16
Fiji,FJ,East Asia & Pacific,2019-05-26,cargo,0,0,0,0,0,0,0,0,2,2,2
Fiji,FJ,East Asia & Pacific,2019-05-26,passenger,893,731,3641,4372,5265,16601196.90717106,5,3,14,17,22
Fiji,FJ,East Asia & Pacific,2019-05-27,cargo,0,0,0,0,0,0,0,1,1,2,2
Fiji,FJ,East Asia & Pacific,2019-05-27,passenger,624,0,3216,3216,3840,9773678.059750201,6,0,10,10,16
Fiji,FJ,East Asia & Pacific,2019-05-28,cargo,0,0,0,0,0,0,0,0,1,1,1
Fiji,FJ,East Asia & Pacific,2019-05-28,passenger,559,273,2552,2825,3384,11901715.395107428,5,1,8,9,14
Fiji,FJ,East Asia & Pacific,2019-05-29,cargo,0,0,0,0,0,0,0,1,1,2,2
Fiji,FJ,East Asia & Pacific,2019-05-29,passenger,856,313,2272,2585,3441,8665838.44986237,5,1,9,10,15
Fiji,FJ,East Asia & Pacific,2019-05-30,cargo,0,0,0,0,0,0,0,1,0,1,1
Fiji,FJ,East Asia & Pacific,2019-05-30,passenger,918,0,2985,2985,3903,10584851.655642482,10,0,9,9,19
Fiji,FJ,East Asia & Pacific,2019-05-31,cargo,0,0,0,0,0,0,0,0,1,1,1
Fiji,FJ,East Asia & Pacific,2019-05-31,passenger,627,586,2911,3497,4124,13685340.40258147,6,2,9,11,17
Fiji,FJ,East Asia & Pacific,2019-06-01,cargo,0,0,0,0,0,0,0,1,1,2,2
Fiji,FJ,East Asia & Pacific,2019-06-01,passenger,778,0,3347,3347,4125,12020615.18852053,6,0,11,11,17
Fiji,FJ,East Asia & Pacific,2019-06-02,cargo,0,0,0,0,0,0,0,1,0,1,1
Fiji,FJ,East Asia & Pacific,2019-06-02,passenger,839,477,4046,4523,5362,15743167.56948574,6,2,14,16,22
Fiji,FJ,East Asia & Pacific,2019-06-03,cargo,0,0,0,0,0,0,0,0,2,2,2
Fiji,FJ,East Asia & Pacific,2019-06-03,passenger,532,273,3304,3577,4109,13778740.436359663,7,1,12,13,20
Fiji,FJ,East Asia & Pacific,2019-06-04,cargo,0,0,0,0,0,0,0,1,0,1,1
Fiji,FJ,East Asia & Pacific,2019-06-04,passenger,556,0,3314,3314,3870,11934823.116162688,6,0,8,8,14
Fiji,FJ,East Asia & Pacific,2019-06-05,cargo,0,0,0,0,0,0,0,1,1,2,2
Fiji,FJ,East Asia & Pacific,2019-06-05,passenger,722,313,2725,3038,3760,9805450.612770852,5,1,11,12,17
Fiji,FJ,East Asia & Pacific,2019-06-06,cargo,0,0,0,0,0,0,0,0,1,1,1
Fiji,FJ,East Asia & Pacific,2019-06-06,passenger,671,273,2939,3212,3883,11433220.566207828,7,1,9,10,17
Fiji,FJ,East Asia & Pacific,2019-06-07,cargo,0,0,0,0,0,0,0,1,1,2,2
Fiji,FJ,East Asia & Pacific,2019-06-07,passenger,448,313,3406,3719,4167,12540208.844501087,4,1,11,12,16
Fiji,FJ,East Asia & Pacific,2019-06-08,cargo,0,0,0,0,0,0,0,1,1,2,2
Fiji,FJ,East Asia & Pacific,2019-06-08,passenger,703,0,3661,3661,4364,10825363.333470996,7,0,11,11,18
Fiji,FJ,East Asia & Pacific,2019-06-09,cargo,0,0,0,0,0,0,0,0,2,2,2
Fiji,FJ,East Asia & Pacific,2019-06-09,passenger,383,750,3391,4141,4524,16068865.211483741,3,3,13,16,19
Fiji,FJ,East Asia & Pacific,2019-06-10,cargo,0,0,0,0,0,0,0,1,1,2,2
Fiji,FJ,East Asia & Pacific,2019-06-10,passenger,671,0,3193,3193,3864,9469692.637055712,5,0,10,10,15
Fiji,FJ,East Asia & Pacific,2019-06-11,cargo,0,0,0,0,0,0,0,1,1,2,2
Fiji,FJ,East Asia & Pacific,2019-06-11,passenger,671,0,3098,3098,3769,11301677.70206566,5,0,8,8,13
Fiji,FJ,East Asia & Pacific,2019-06-12,cargo,0,0,0,0,0,0,0,0,2,2,2
Fiji,FJ,East Asia & Pacific,2019-06-12,passenger,722,586,2796,3382,4104,13336621.254762884,5,2,11,13,18
Fiji,FJ,East Asia & Pacific,2019-06-13,cargo,0,0,0,0,0,0,0,1,1,2,2
Fiji,FJ,East Asia & Pacific,2019-06-13,passenger,842,0,2941,2941,3783,10740792.152102519,8,0,10,10,18
Fiji,FJ,East Asia & Pacific,2019-06-14,cargo,0,0,0,0,0,0,0,1,1,2,2
Fiji,FJ,East Asia & Pacific,2019-06-14,passenger,597,313,3312,3625,4222,12846933.582447335,5,1,9,10,15
Fiji,FJ,East Asia & Pacific,2019-06-15,cargo,0,0,0,0,0,0,0,0,2,2,2
Fiji,FJ,East Asia & Pacific,2019-06-15,passenger,703,273,3251,3524,4227,12576852.681847524,6,1,10,11,17
Fiji,FJ,East Asia & Pacific,2019-06-16,cargo,0,0,0,0,0,0,0,1,1,2,2
Fiji,FJ,East Asia & Pacific,2019-06-16,passenger,744,477,3527,4004,4748,15665611.763326084,4,2,13,15,19
Fiji,FJ,East Asia & Pacific,2019-06-17,cargo,0,0,0,0,0,0,0,1,1,2,2
Fiji,FJ,East Asia & Pacific,2019-06-17,passenger,600,0,3113,3113,3713,9119383.951826895,5,0,12,12,17
Fiji,FJ,East Asia & Pacific,2019-06-18,cargo,0,0,0,0,0,0,0,0,1,1,1
Fiji,FJ,East Asia & Pacific,2019-06-18,passenger,575,527,3172,3699,4274,16016556.151250558,6,2,9,11,17
Fiji,FJ,East Asia & Pacific,2019-06-19,cargo,0,0,0,0,0,0,0,1,1,2,2
Fiji,FJ,East Asia & Pacific,2019-06-19,passenger,733,313,2737,3050,3783,11312029.902225824,5,1,11,12,17
Fiji,FJ,East Asia & Pacific,2019-06-20,cargo,0,0,0,0,0,0,0,1,1,2,2
Fiji,FJ,East Asia & Pacific,2019-06-20,passenger,758,0,3506,3506,4264,10530569.380161803,6,0,9,9,15
Fiji,FJ,East Asia & Pacific,2019-06-21,cargo,0,0,0,0,0,0,0,0,3,3,3
Fiji,FJ,East Asia & Pacific,2019-06-21,passenger,535,586,2953,3539,4074,12871212.365089498,6,2,10,12,18
Fiji,FJ,East Asia & Pacific,2019-06-22,cargo,0,0,0,0,0,0,0,1,1,2,2
Fiji,FJ,East Asia & Pacific,2019-06-22,passenger,635,0,3848,3848,4483,12934911.132658279,5,0,12,12,17
Fiji,FJ,East Asia & Pacific,2019-06-23,cargo,0,0,0,0,0,0,0,1,1,2,2
Fiji,FJ,East Asia & Pacific,2019-06-23,passenger,850,483,3531,4014,4864,14169766.805534171,6,2,14,16,22
Fiji,FJ,East Asia & Pacific,2019-06-24,cargo,0,0,0,0,0,0,0,0,2,2,2
Fiji,FJ,East Asia & Pacific,2019-06-24,passenger,627,273,2881,3154,3781,11213099.318393866,5,1,10,11,16
Fiji,FJ,East Asia & Pacific,2019-06-25,cargo,0,0,0,0,0,0,0,1,1,2,2
Fiji,FJ,East Asia & Pacific,2019-06-25,passenger,537,254,3178,3432,3969,13233319.485038113,5,1,10,11,16
Fiji,FJ,East Asia & Pacific,2019-06-26,cargo,0,0,0,0,0,0,0,0,2,2,2
Fiji,FJ,East Asia & Pacific,2019-06-26,passenger,806,586,2574,3160,3966,11698708.64616971,5,2,11,13,18
Fiji,FJ,East Asia & Pacific,2019-06-27,cargo,0,0,0,0,0,0,0,1,1,2,2
Fiji,FJ,East Asia & Pacific,2019-06-27,passenger,842,0,3674,3674,4516,12639981.163084174,8,0,10,10,18
Fiji,FJ,East Asia & Pacific,2019-06-28,cargo,0,0,0,0,0,0,0,1,1,2,2
Fiji,FJ,East Asia & Pacific,2019-06-28,passenger,646,313,3529,3842,4488,13695216.00522775,5,1,10,11,16
Fiji,FJ,East Asia & Pacific,2019-06-29,cargo,0,0,0,0,0,0,0,1,1,2,2
Fiji,FJ,East Asia & Pacific,2019-06-29,passenger,627,0,4138,4138,4765,12680077.319620064,5,0,10,10,15
Fiji,FJ,East Asia & Pacific,2019-06-30,cargo,0,0,0,0,0,0,0,0,2,2,2
Fiji,FJ,East Asia & Pacific,2019-06-30,passenger,1054,750,3836,4586,5640,17086722.73977669,8,3,13,16,24
Fiji,FJ,East Asia & Pacific,2019-07-01,cargo,0,0,0,0,0,0,0,1,1,2,2
Fiji,FJ,East Asia & Pacific,2019-07-01,passenger,657,0,4061,4061,4718,13729080.374982692,6,0,13,13,19
Fiji,FJ,East Asia & Pacific,2019-07-02,cargo,0,0,0,0,0,0,0,1,0,1,1
Fiji,FJ,East Asia & Pacific,2019-07-02,passenger,575,221,3365,3586,4161,12656704.955766922,4,1,9,10,14
Fiji,FJ,East Asia & Pacific,2019-07-03,cargo,0,0,0,0,0,0,0,1,1,2,2
Fiji,FJ,East Asia & Pacific,2019-07-03,passenger,844,313,3345,3658,4502,11218086.029690407,6,1,11,12,18
Fiji,FJ,East Asia & Pacific,2019-07-04,cargo,0,0,0,0,0,0,0,0,2,2,2
Fiji,FJ,East Asia & Pacific,2019-07-04,passenger,864,273,3702,3975,4839,13757967.008996729,8,1,10,11,19
Fiji,FJ,East Asia & Pacific,2019-07-05,cargo,0,0,0,0,0,0,0,1,2,3,3
Fiji,FJ,East Asia & Pacific,2019-07-05,passenger,646,313,4092,4405,5051,14622136.961346272,5,1,11,12,17
Fiji,FJ,East Asia & Pacific,2019-07-06,cargo,0,0,0,0,0,0,0,0,2,2,2
Fiji,FJ,East Asia & Pacific,2019-07-06,passenger,741,273,3844,4117,4858,14149583.140306454,6,1,10,11,17
Fiji,FJ,East Asia & Pacific,2019-07-07,cargo,0,0,0,0,0,0,0,1,1,2,2
Fiji,FJ,East Asia & Pacific,2019-07-07,passenger,687,483,4586,5069,5756,18539252.66575851,4,2,15,17,21
Fiji,FJ,East Asia & Pacific,2019-07-08,cargo,0,0,0,0,0,0,0,1,1,2,2
Fiji,FJ,East Asia & Pacific,2019-07-08,passenger,665,0,3916,3916,4581,13171145.073173758,5,0,13,13,18
Fiji,FJ,East Asia & Pacific,2019-07-09,cargo,0,0,0,0,0,0,0,0,1,1,1
Fiji,FJ,East Asia & Pacific,2019-07-09,passenger,526,715,3935,4650,5176,17694853.533018544,7,2,9,11,18
Fiji,FJ,East Asia & Pacific,2019-07-10,cargo,0,0,0,0,0,0,0,1,1,2,2
Fiji,FJ,East Asia & Pacific,2019-07-10,passenger,817,313,3314,3627,4444,11328010.00711456,6,1,11,12,18
Fiji,FJ,East Asia & Pacific,2019-07-11,cargo,0,0,0,0,0,0,0,0,2,2,2
Fiji,FJ,East Asia & Pacific,2019-07-11,passenger,891,273,3410,3683,4574,13050320.665021075,7,1,10,11,18
Fiji,FJ,East Asia & Pacific,2019-07-12,cargo,0,0,0,0,0,0,0,1,1,2,2
Fiji,FJ,East Asia & Pacific,2019-07-12,passenger,646,534,3991,4525,5171,15508301.154713383,5,2,11,13,18
Fiji,FJ,East Asia & Pacific,2019-07-13,cargo,0,0,0,0,0,0,0,1,1,2,2
Fiji,FJ,East Asia & Pacific,2019-07-13,passenger,779,0,4796,4796,5575,14113202.714082846,6,0,12,12,18
Fiji,FJ,East Asia & Pacific,2019-07-14,cargo,0,0,0,0,0,0,0,0,2,2,2
Fiji,FJ,East Asia & Pacific,2019-07-14,passenger,858,750,3998,4748,5606,19017319.32462977,5,3,15,18,23
Fiji,FJ,East Asia & Pacific,2019-07-15,cargo,0,0,0,0,0,0,0,1,1,2,2
Fiji,FJ,East Asia & Pacific,2019-07-15,passenger,665,0,4176,4176,4841,12080814.432407735,5,0,12,12,17
Fiji,FJ,East Asia & Pacific,2019-07-16,cargo,0,0,0,0,0,0,0,0,2,2,2
Fiji,FJ,East Asia & Pacific,2019-07-16,passenger,556,273,3616,3889,4445,14449670.9138722,5,1,9,10,15
Fiji,FJ,East Asia & Pacific,2019-07-17,cargo,0,0,0,0,0,0,0,1,1,2,2
Fiji,FJ,East Asia & Pacific,2019-07-17,passenger,844,313,3413,3726,4570,12917928.105346546,6,1,11,12,18
Fiji,FJ,East Asia & Pacific,2019-07-18,cargo,0,0,0,0,0,0,0,1,1,2,2
Fiji,FJ,East Asia & Pacific,2019-07-18,passenger,891,0,3290,3290,4181,11671293.300324222,7,0,10,10,17
Fiji,FJ,East Asia & Pacific,2019-07-19,cargo,0,0,0,0,0,0,0,1,1,2,2
Fiji,FJ,East Asia & Pacific,2019-07-19,passenger,684,313,3532,3845,4529,12825184.2759328,5,1,9,10,15
Fiji,FJ,East Asia & Pacific,2019-07-20,cargo,0,0,0,0,0,0,0,1,1,2,2
Fiji,FJ,East Asia & Pacific,2019-07-20,passenger,673,0,4893,4893,5566,14558055.616985166,5,0,12,12,17
Fiji,FJ,East Asia & Pacific,2019-07-21,cargo,0,0,0,0,0,0,0,0,2,2,2
Fiji,FJ,East Asia & Pacific,2019-07-21,passenger,899,750,4184,4934,5833,18941633.28584597,5,3,15,18,23
Fiji,FJ,East Asia & Pacific,2019-07-22,cargo,0,0,0,0,0,0,0,1,1,2,2
Fiji,FJ,East Asia & Pacific,2019-07-22,passenger,889,0,4262,4262,5151,13805408.88554114,6,0,12,12,18
Fiji,FJ,East Asia & Pacific,2019-07-23,cargo,0,0,0,0,0,0,0,1,0,1,1
Fiji,FJ,East Asia & Pacific,2019-07-23,passenger,575,0,3642,3642,4217,12021896.580891112,6,0,9,9,15
Fiji,FJ,East Asia & Pacific,2019-07-24,cargo,0,0,0,0,0,0,0,0,2,2,2
Fiji,FJ,East Asia & Pacific,2019-07-24,passenger,882,586,2823,3409,4291,12321745.362987855,7,2,11,13,20
Fiji,FJ,East Asia & Pacific,2019-07-25,cargo,0,0,0,0,0,0,0,1,1,2,2
Fiji,FJ,East Asia & Pacific,2019-07-25,passenger,959,0,3756,3756,4715,14077420.465477237,9,0,10,10,19
Fiji,FJ,East Asia & Pacific,2019-07-26,cargo,0,0,0,0,0,0,0,2,0,2,2
Fiji,FJ,East Asia & Pacific,2019-07-26,passenger,494,313,3200,3513,4007,11955445.265350744,6,1,10,11,17
Fiji,FJ,East Asia & Pacific,2019-07-27,cargo,0,0,0,0,0,0,0,0,2,2,2
Fiji,FJ,East Asia & Pacific,2019-07-27,passenger,662,273,4382,4655,5317,15979059.85627224,7,1,9,10,17
Fiji,FJ,East Asia & Pacific,2019-07-28,cargo,0,0,0,0,0,0,0,1,1,2,2
Fiji,FJ,East Asia & Pacific,2019-07-28,passenger,869,477,4030,4507,5376,18135892.78821997,6,2,13,15,21
Fiji,FJ,East Asia & Pacific,2019-07-29,cargo,0,0,0,0,0,0,0,1,1,2,2
Fiji,FJ,East Asia & Pacific,2019-07-29,passenger,823,0,3306,3306,4129,11137465.176423164,5,0,11,11,16
Fiji,FJ,East Asia & Pacific,2019-07-30,cargo,0,0,0,0,0,0,0,1,1,2,2
Fiji,FJ,East Asia & Pacific,2019-07-30,passenger,801,0,3323,3323,4124,10431098.754337618,7,0,8,8,15
Fiji,FJ,East Asia & Pacific,2019-07-31,cargo,0,0,0,0,0,0,0,0,2,2,2
Fiji,FJ,East Asia & Pacific,2019-07-31,passenger,901,586,2451,3037,3938,11449705.670915889,6,2,11,13,19
Fiji,FJ,East Asia & Pacific,2019-08-01,cargo,0,0,0,0,0,0,0,1,1,2,2
Fiji,FJ,East Asia & Pacific,2019-08-01,passenger,891,0,3811,3811,4702,13096902.618219214,8,0,10,10,18
Fiji,FJ,East Asia & Pacific,2019-08-02,cargo,0,0,0,0,0,0,0,1,1,2,2
Fiji,FJ,East Asia & Pacific,2019-08-02,passenger,684,567,3577,4144,4828,14436261.558831736,4,1,9,10,14
Fiji,FJ,East Asia & Pacific,2019-08-03,cargo,0,0,0,0,0,0,0,0,2,2,2
Fiji,FJ,East Asia & Pacific,2019-08-03,passenger,768,273,3653,3926,4694,13660450.926280722,8,1,10,11,19
Fiji,FJ,East Asia & Pacific,2019-08-04,cargo,0,0,0,0,0,0,0,1,1,2,2
Fiji,FJ,East Asia & Pacific,2019-08-04,passenger,798,483,3891,4374,5172,17582531.214994233,6,2,14,16,22
Fiji,FJ,East Asia & Pacific,2019-08-05,cargo,0,0,0,0,0,0,0,1,1,2,2
Fiji,FJ,East Asia & Pacific,2019-08-05,passenger,742,0,3120,3120,3862,11196048.966164062,5,0,10,10,15
Fiji,FJ,East Asia & Pacific,2019-08-06,cargo,0,0,0,0,0,0,0,0,2,2,2
Fiji,FJ,East Asia & Pacific,2019-08-06,passenger,733,273,2870,3143,3876,12352527.18561754,6,1,9,10,16
Fiji,FJ,East Asia & Pacific,2019-08-07,cargo,0,0,0,0,0,0,0,1,1,2,2
Fiji,FJ,East Asia & Pacific,2019-08-07,passenger,798,313,2956,3269,4067,11979783.21207042,5,1,12,13,18
Fiji,FJ,East Asia & Pacific,2019-08-08,cargo,0,0,0,0,0,0,0,1,1,2,2
Fiji,FJ,East Asia & Pacific,2019-08-08,passenger,853,0,3634,3634,4487,11030055.527766187,6,0,10,10,16
Fiji,FJ,East Asia & Pacific,2019-08-09,cargo,0,0,0,0,0,0,0,0,2,2,2
Fiji,FJ,East Asia & Pacific,2019-08-09,passenger,627,586,2939,3525,4152,12729215.245668566,5,2,10,12,17
Fiji,FJ,East Asia & Pacific,2019-08-10,cargo,0,0,0,0,0,0,0,1,1,2,2
Fiji,FJ,East Asia & Pacific,2019-08-10,passenger,662,0,4014,4014,4676,13587365.088102462,5,0,12,12,17
Fiji,FJ,East Asia & Pacific,2019-08-11,cargo,0,0,0,0,0,0,0,1,1,2,2
Fiji,FJ,East Asia & Pacific,2019-08-11,passenger,888,435,3987,4422,5310,17812842.037441466,6,2,13,15,21
Fiji,FJ,East Asia & Pacific,2019-08-12,cargo,0,0,0,0,0,0,0,1,1,2,2
Fiji,FJ,East Asia & Pacific,2019-08-12,passenger,749,0,2940,2940,3689,10199260.448206862,6,0,11,11,17
Fiji,FJ,East Asia & Pacific,2019-08-13,cargo,0,0,0,0,0,0,0,1,2,3,3
Fiji,FJ,East Asia & Pacific,2019-08-13,passenger,594,254,3054,3308,3902,12646299.778665803,5,1,9,10,15
Fiji,FJ,East Asia & Pacific,2019-08-14,cargo,0,0,0,0,0,0,0,0,2,2,2
Fiji,FJ,East Asia & Pacific,2019-08-14,passenger,825,586,2742,3328,4153,12285927.775022862,6,2,11,13,19
Fiji,FJ,East Asia & Pacific,2019-08-15,cargo,0,0,0,0,0,0,0,1,1,2,2
Fiji,FJ,East Asia & Pacific,2019-08-15,passenger,1046,0,3374,3374,4420,11983522.469679508,8,0,10,10,18
Fiji,FJ,East Asia & Pacific,2019-08-16,cargo,0,0,0,0,0,0,0,1,0,1,1
Fiji,FJ,East Asia & Pacific,2019-08-16,passenger,777,313,3267,3580,4357,12433518.807629174,6,1,10,11,17
Fiji,FJ,East Asia & Pacific,2019-08-17,cargo,0,0,0,0,0,0,0,0,2,2,2
Fiji,FJ,East Asia & Pacific,2019-08-17,passenger,840,273,4105,4378,5218,15273216.243381416,6,1,10,11,17
Fiji,FJ,East Asia & Pacific,2019-08-18,cargo,0,0,0,0,0,0,0,1,1,2,2
Fiji,FJ,East Asia & Pacific,2019-08-18,passenger,791,435,3171,3606,4397,15412508.976427313,5,2,10,12,17
Fiji,FJ,East Asia & Pacific,2019-08-19,cargo,0,0,0,0,0,0,0,1,1,2,2
Fiji,FJ,East Asia & Pacific,2019-08-19,passenger,826,0,2722,2722,3548,9586681.527660964,5,0,11,11,16
Fiji,FJ,East Asia & Pacific,2019-08-20,cargo,0,0,0,0,0,0,0,1,2,3,3
Fiji,FJ,East Asia & Pacific,2019-08-20,passenger,575,0,2788,2788,3363,9974784.962110257,5,0,9,9,14
Fiji,FJ,East Asia & Pacific,2019-08-21,cargo,0,0,0,0,0,0,0,1,2,3,3
Fiji,FJ,East Asia & Pacific,2019-08-21,passenger,828,586,2355,2941,3769,11462541.556540199,6,2,10,12,18
Fiji,FJ,East Asia & Pacific,2019-08-22,cargo,0,0,0,0,0,0,0,1,1,2,2
Fiji,FJ,East Asia & Pacific,2019-08-22,passenger,853,0,2786,2786,3639,10368870.162923057,7,0,10,10,17
Fiji,FJ,East Asia & Pacific,2019-08-23,cargo,0,0,0,0,0,0,0,1,1,2,2
Fiji,FJ,East Asia & Pacific,2019-08-23,passenger,559,313,2375,2688,3247,9857374.473231744,5,1,9,10,15
Fiji,FJ,East Asia & Pacific,2019-08-24,cargo,0,0,0,0,0,0,0,0,2,2,2
Fiji,FJ,East Asia & Pacific,2019-08-24,passenger,586,273,3372,3645,4231,12745071.920579322,5,1,10,11,16
Fiji,FJ,East Asia & Pacific,2019-08-25,cargo,0,0,0,0,0,0,0,1,1,2,2
Fiji,FJ,East Asia & Pacific,2019-08-25,passenger,877,477,3246,3723,4600,15702234.091716284,7,2,12,14,21
Fiji,FJ,East Asia & Pacific,2019-08-26,cargo,0,0,0,0,0,0,0,1,1,2,2
Fiji,FJ,East Asia & Pacific,2019-08-26,passenger,665,0,2844,2844,3509,10027198.985077009,7,0,11,11,18
Fiji,FJ,East Asia & Pacific,2019-08-27,cargo,0,0,0,0,0,0,0,1,2,3,3
Fiji,FJ,East Asia & Pacific,2019-08-27,passenger,556,0,2468,2468,3024,9022560.759949137,5,0,9,9,14
Fiji,FJ,East Asia & Pacific,2019-08-28,cargo,0,0,0,0,0,0,0,0,2,2,2
Fiji,FJ,East Asia & Pacific,2019-08-28,passenger,798,586,2124,2710,3508,10513311.455952004,6,2,10,12,18
Fiji,FJ,East Asia & Pacific,2019-08-29,cargo,0,0,0,0,0,0,0,1,1,2,2
Fiji,FJ,East Asia & Pacific,2019-08-29,passenger,861,0,2661,2661,3522,10027885.897739943,8,0,10,10,18
Fiji,FJ,East Asia & Pacific,2019-08-30,cargo,0,0,0,0,0,0,0,1,2,3,3
Fiji,FJ,East Asia & Pacific,2019-08-30,passenger,665,313,2318,2631,3296,10089368.976038283,5,1,8,9,14
Fiji,FJ,East Asia & Pacific,2019-08-31,cargo,0,0,0,0,0,0,0,0,2,2,2
Fiji,FJ,East Asia & Pacific,2019-08-31,passenger,605,273,3177,3450,4055,12738586.194976375,6,1,9,10,16
Fiji,FJ,East Asia & Pacific,2019-09-01,cargo,0,0,0,0,0,0,0,1,1,2,2
Fiji,FJ,East Asia & Pacific,2019-09-01,passenger,744,477,3378,3855,4599,15999333.150420433,5,2,13,15,20
Fiji,FJ,East Asia & Pacific,2019-09-02,cargo,0,0,0,0,0,0,0,1,2,3,3
Fiji,FJ,East Asia & Pacific,2019-09-02,passenger,608,0,2824,2824,3432,10232008.548959246,5,0,10,10,15
Fiji,FJ,East Asia & Pacific,2019-09-03,cargo,0,0,0,0,0,0,0,0,1,1,1
Fiji,FJ,East Asia & Pacific,2019-09-03,passenger,624,273,2797,3070,3694,12598059.443549177,5,1,9,10,15
Fiji,FJ,East Asia & Pacific,2019-09-04,cargo,0,0,0,0,0,0,0,1,1,2,2
Fiji,FJ,East Asia & Pacific,2019-09-04,passenger,871,313,2380,2693,3564,10364479.505562698,6,1,11,12,18
Fiji,FJ,East Asia & Pacific,2019-09-05,cargo,0,0,0,0,0,0,0,1,0,1,1
Fiji,FJ,East Asia & Pacific,2019-09-05,passenger,823,0,3242,3242,4065,9990277.544473313,8,0,10,10,18
Fiji,FJ,East Asia & Pacific,2019-09-06,cargo,0,0,0,0,0,0,0,1,1,2,2
Fiji,FJ,East Asia & Pacific,2019-09-06,passenger,630,313,2763,3076,3706,11172371.728855385,7,1,9,10,17
Fiji,FJ,East Asia & Pacific,2019-09-07,cargo,0,0,0,0,0,0,0,0,2,2,2
Fiji,FJ,East Asia & Pacific,2019-09-07,passenger,711,273,3686,3959,4670,13915336.827411968,6,1,10,11,17
Fiji,FJ,East Asia & Pacific,2019-09-08,cargo,0,0,0,0,0,0,0,1,1,2,2
Fiji,FJ,East Asia & Pacific,2019-09-08,passenger,657,483,3326,3809,4466,15095976.027185157,5,2,12,14,19
Fiji,FJ,East Asia & Pacific,2019-09-09,cargo,0,0,0,0,0,0,0,1,1,2,2
Fiji,FJ,East Asia & Pacific,2019-09-09,passenger,627,0,2953,2953,3580,10430549.843992993,5,0,11,11,16
Fiji,FJ,East Asia & Pacific,2019-09-10,cargo,0,0,0,0,0,0,0,0,2,2,2
Fiji,FJ,East Asia & Pacific,2019-09-10,passenger,632,273,2484,2757,3389,11586622.6532945,5,1,9,10,15
Fiji,FJ,East Asia & Pacific,2019-09-11,cargo,0,0,0,0,0,0,0,1,1,2,2
Fiji,FJ,East Asia & Pacific,2019-09-11,passenger,825,567,2672,3239,4064,14803116.964056807,6,2,11,13,19
Fiji,FJ,East Asia & Pacific,2019-09-12,cargo,0,0,0,0,0,0,0,1,1,2,2
Fiji,FJ,East Asia & Pacific,2019-09-12,passenger,883,0,3242,3242,4125,10004521.852924991,8,0,10,10,18
Fiji,FJ,East Asia & Pacific,2019-09-13,cargo,0,0,0,0,0,0,0,1,1,2,2
Fiji,FJ,East Asia & Pacific,2019-09-13,passenger,600,313,2538,2851,3451,10521185.74986546,5,1,9,10,15
Fiji,FJ,East Asia & Pacific,2019-09-14,cargo,0,0,0,0,0,0,0,0,2,2,2
Fiji,FJ,East Asia & Pacific,2019-09-14,passenger,732,273,3418,3691,4423,13397532.598806478,7,1,9,10,17
Fiji,FJ,East Asia & Pacific,2019-09-15,cargo,0,0,0,0,0,0,0,1,1,2,2
Fiji,FJ,East Asia & Pacific,2019-09-15,passenger,630,477,3841,4318,4948,17527004.128828377,5,2,13,15,20
Fiji,FJ,East Asia & Pacific,2019-09-16,cargo,0,0,0,0,0,0,0,1,1,2,2
Fiji,FJ,East Asia & Pacific,2019-09-16,passenger,570,0,2715,2715,3285,9988718.817263665,6,0,10,10,16
Fiji,FJ,East Asia & Pacific,2019-09-17,cargo,0,0,0,0,0,0,0,0,1,1,1
Fiji,FJ,East Asia & Pacific,2019-09-17,passenger,602,273,3080,3353,3955,12923030.207785213,5,1,9,10,15
Fiji,FJ,East Asia & Pacific,2019-09-18,cargo,0,0,0,0,0,0,0,1,1,2,2
Fiji,FJ,East Asia & Pacific,2019-09-18,passenger,779,313,2633,2946,3725,9873238.671984233,6,1,9,10,16
Fiji,FJ,East Asia & Pacific,2019-09-19,cargo,0,0,0,0,0,0,0,0,2,2,2
Fiji,FJ,East Asia & Pacific,2019-09-19,passenger,750,273,3981,4254,5004,15790676.476642443,7,1,11,12,19
Fiji,FJ,East Asia & Pacific,2019-09-20,cargo,0,0,0,0,0,0,0,1,1,2,2
Fiji,FJ,East Asia & Pacific,2019-09-20,passenger,494,313,2713,3026,3520,11159358.943725655,5,1,9,10,15
Fiji,FJ,East Asia & Pacific,2019-09-21,cargo,0,0,0,0,0,0,0,1,1,2,2
Fiji,FJ,East Asia & Pacific,2019-09-21,passenger,692,0,4972,4972,5664,15106317.790807066,6,0,10,10,16
Fiji,FJ,East Asia & Pacific,2019-09-22,cargo,0,0,0,0,0,0,0,0,1,1,1
Fiji,FJ,East Asia & Pacific,2019-09-22,passenger,698,708,3517,4225,4923,17295831.828500997,4,3,12,15,19
Fiji,FJ,East Asia & Pacific,2019-09-23,cargo,0,0,0,0,0,0,0,1,1,2,2
Fiji,FJ,East Asia & Pacific,2019-09-23,passenger,543,0,3753,3753,4296,12690698.58639874,4,0,12,12,16
Fiji,FJ,East Asia & Pacific,2019-09-24,cargo,0,0,0,0,0,0,0,1,0,1,1
Fiji,FJ,East Asia & Pacific,2019-09-24,passenger,499,0,3054,3054,3553,10770315.367909268,4,0,8,8,12
Fiji,FJ,East Asia & Pacific,2019-09-25,cargo,0,0,0,0,0,0,0,0,2,2,2
Fiji,FJ,East Asia & Pacific,2019-09-25,passenger,817,586,2356,2942,3759,11206400.94841085,6,2,10,12,18
Fiji,FJ,East Asia & Pacific,2019-09-26,cargo,0,0,0,0,0,0,0,1,1,2,2
Fiji,FJ,East Asia & Pacific,2019-09-26,passenger,864,0,3700,3700,4564,11326373.579220064,8,0,10,10,18
Fiji,FJ,East Asia & Pacific,2019-09-27,cargo,0,0,0,0,0,0,0,0,2,2,2
Fiji,FJ,East Asia & Pacific,2019-09-27,passenger,711,586,3116,3702,4413,14859917.301029744,6,2,9,11,17
Fiji,FJ,East Asia & Pacific,2019-09-28,cargo,0,0,0,0,0,0,0,1,1,2,2
Fiji,FJ,East Asia & Pacific,2019-09-28,passenger,627,0,5089,5089,5716,16768823.505880274,6,0,11,11,17
Fiji,FJ,East Asia & Pacific,2019-09-29,cargo,0,0,0,0,0,0,0,1,1,2,2
Fiji,FJ,East Asia & Pacific,2019-09-29,passenger,679,435,3769,4204,4883,14372452.109174443,4,2,12,14,18
Fiji,FJ,East Asia & Pacific,2019-09-30,cargo,0,0,0,0,0,0,0,0,2,2,2
Fiji,FJ,East Asia & Pacific,2019-09-30,passenger,407,273,3070,3343,3750,13177684.459748212,5,1,11,12,17
Fiji,FJ,East Asia & Pacific,2019-10-01,cargo,0,0,0,0,0,0,0,1,0,1,1
Fiji,FJ,East Asia & Pacific,2019-10-01,passenger,46,0,2834,2834,2880,8817602.34962956,1,0,7,7,8
Fiji,FJ,East Asia & Pacific,2019-10-02,cargo,0,0,0,0,0,0,0,1,1,2,2
Fiji,FJ,East Asia & Pacific,2019-10-02,passenger,806,313,2793,3106,3912,10210377.973608263,5,1,10,11,16
Fiji,FJ,East Asia & Pacific,2019-10-03,cargo,0,0,0,0,0,0,0,0,2,2,2
Fiji,FJ,East Asia & Pacific,2019-10-03,passenger,940,273,3288,3561,4501,11305960.404442517,9,1,9,10,19
Fiji,FJ,East Asia & Pacific,2019-10-04,cargo,0,0,0,0,0,0,0,1,1,2,2
Fiji,FJ,East Asia & Pacific,2019-10-04,passenger,646,313,3051,3364,4010,12166413.506743776,5,1,9,10,15
Fiji,FJ,East Asia & Pacific,2019-10-05,cargo,0,0,0,0,0,0,0,1,1,2,2
Fiji,FJ,East Asia & Pacific,2019-10-05,passenger,426,0,4752,4752,5178,13900069.122581689,5,0,10,10,15
Fiji,FJ,East Asia & Pacific,2019-10-06,cargo,0,0,0,0,0,0,0,0,2,2,2
Fiji,FJ,East Asia & Pacific,2019-10-06,passenger,850,708,3788,4496,5346,15743246.083048841,6,3,10,13,19
Fiji,FJ,East Asia & Pacific,2019-10-07,cargo,0,0,0,0,0,0,0,1,1,2,2
Fiji,FJ,East Asia & Pacific,2019-10-07,passenger,646,0,3146,3146,3792,11005074.437054459,5,0,12,12,17
Fiji,FJ,East Asia & Pacific,2019-10-08,cargo,0,0,0,0,0,0,0,1,1,2,2
Fiji,FJ,East Asia & Pacific,2019-10-08,passenger,575,0,3386,3386,3961,10247297.395174315,4,0,8,8,12
Fiji,FJ,East Asia & Pacific,2019-10-09,cargo,0,0,0,0,0,0,0,0,2,2,2
Fiji,FJ,East Asia & Pacific,2019-10-09,passenger,882,586,2802,3388,4270,12362964.00244256,6,2,10,12,18
Fiji,FJ,East Asia & Pacific,2019-10-10,cargo,0,0,0,0,0,0,0,1,1,2,2
Fiji,FJ,East Asia & Pacific,2019-10-10,passenger,891,0,3267,3267,4158,10395981.933860116,7,0,10,10,17
Fiji,FJ,East Asia & Pacific,2019-10-11,cargo,0,0,0,0,0,0,0,1,1,2,2
Fiji,FJ,East Asia & Pacific,2019-10-11,passenger,657,313,3792,4105,4762,14205738.68107727,6,1,9,10,16
Fiji,FJ,East Asia & Pacific,2019-10-12,cargo,0,0,0,0,0,0,0,0,2,2,2
Fiji,FJ,East Asia & Pacific,2019-10-12,passenger,662,273,3986,4259,4921,14597587.998169294,6,1,11,12,18
Fiji,FJ,East Asia & Pacific,2019-10-13,cargo,0,0,0,0,0,0,0,1,1,2,2
Fiji,FJ,East Asia & Pacific,2019-10-13,passenger,831,483,3551,4034,4865,12980091.997082492,5,2,10,12,17
Fiji,FJ,East Asia & Pacific,2019-10-14,cargo,0,0,0,0,0,0,0,0,2,2,2
Fiji,FJ,East Asia & Pacific,2019-10-14,passenger,684,273,3223,3496,4180,13268478.862397466,7,1,11,12,19
Fiji,FJ,East Asia & Pacific,2019-10-15,cargo,0,0,0,0,0,0,0,1,0,1,1
Fiji,FJ,East Asia & Pacific,2019-10-15,passenger,526,0,2466,2466,2992,7181495.161159295,5,0,7,7,12
Fiji,FJ,East Asia & Pacific,2019-10-16,cargo,0,0,0,0,0,0,0,1,1,2,2
Fiji,FJ,East Asia & Pacific,2019-10-16,passenger,874,313,2948,3261,4135,11438038.446324496,7,1,10,11,18
Fiji,FJ,East Asia & Pacific,2019-10-17,cargo,0,0,0,0,0,0,0,0,2,2,2
Fiji,FJ,East Asia & Pacific,2019-10-17,passenger,796,273,3174,3447,4243,11537614.747994209,5,1,9,10,15
Fiji,FJ,East Asia & Pacific,2019-10-18,cargo,0,0,0,0,0,0,0,1,0,1,1
Fiji,FJ,East Asia & Pacific,2019-10-18,passenger,486,313,2862,3175,3661,11512284.649465557,5,1,9,10,15
Fiji,FJ,East Asia & Pacific,2019-10-19,cargo,0,0,0,0,0,0,0,0,2,2,2
Fiji,FJ,East Asia & Pacific,2019-10-19,passenger,673,273,3596,3869,4542,13661030.194713691,7,1,10,11,18
Fiji,FJ,East Asia & Pacific,2019-10-20,cargo,0,0,0,0,0,0,0,1,1,2,2
Fiji,FJ,East Asia & Pacific,2019-10-20,passenger,847,435,3244,3679,4526,13663312.659619465,6,2,11,13,19
Fiji,FJ,East Asia & Pacific,2019-10-21,cargo,0,0,0,0,0,0,0,0,1,1,1
Fiji,FJ,East Asia & Pacific,2019-10-21,passenger,578,273,2798,3071,3649,10321354.948059354,5,1,10,11,16
Fiji,FJ,East Asia & Pacific,2019-10-22,cargo,0,0,0,0,0,0,0,1,0,1,1
Fiji,FJ,East Asia & Pacific,2019-10-22,passenger,556,0,2602,2602,3158,8789730.754021905,4,0,8,8,12
Fiji,FJ,East Asia & Pacific,2019-10-23,cargo,0,0,0,0,0,0,1,1,1,2,3
Fiji,FJ,East Asia & Pacific,2019-10-23,passenger,894,586,2670,3256,4150,13262427.081735134,5,2,11,13,18
Fiji,FJ,East Asia & Pacific,2019-10-24,cargo,0,0,0,0,0,0,0,1,1,2,2
Fiji,FJ,East Asia & Pacific,2019-10-24,passenger,891,0,2981,2981,3872,9895563.49850692,7,0,10,10,17
Fiji,FJ,East Asia & Pacific,2019-10-25,cargo,0,0,0,0,0,0,0,1,1,2,2
Fiji,FJ,East Asia & Pacific,2019-10-25,passenger,911,313,2340,2653,3564,10059414.693964442,7,1,8,9,16
Fiji,FJ,East Asia & Pacific,2019-10-26,cargo,0,0,0,0,0,0,0,1,1,2,2
Fiji,FJ,East Asia & Pacific,2019-10-26,passenger,673,0,3310,3310,3983,11743548.530667827,6,0,11,11,17
Fiji,FJ,East Asia & Pacific,2019-10-27,cargo,0,0,0,0,0,0,0,1,1,2,2
Fiji,FJ,East Asia & Pacific,2019-10-27,passenger,676,435,3403,3838,4514,13911423.462724036,5,2,11,13,18
Fiji,FJ,East Asia & Pacific,2019-10-28,cargo,0,0,0,0,0,0,0,1,0,1,1
Fiji,FJ,East Asia & Pacific,2019-10-28,passenger,684,0,3105,3105,3789,10886269.183929078,5,0,10,10,15
Fiji,FJ,East Asia & Pacific,2019-10-29,cargo,0,0,0,0,0,0,0,0,1,1,1
Fiji,FJ,East Asia & Pacific,2019-10-29,passenger,575,273,2264,2537,3112,9896201.684159707,4,1,8,9,13
Fiji,FJ,East Asia & Pacific,2019-10-30,cargo,0,0,0,0,0,0,1,1,0,1,2
Fiji,FJ,East Asia & Pacific,2019-10-30,passenger,894,313,2679,2992,3886,9818051.164577093,5,1,11,12,17
Fiji,FJ,East Asia & Pacific,2019-10-31,cargo,0,0,0,0,0,0,0,0,1,1,1
Fiji,FJ,East Asia & Pacific,2019-10-31,passenger,959,273,2879,3152,4111,11965048.604616156,8,1,9,10,18
Fiji,FJ,East Asia & Pacific,2019-11-01,cargo,0,0,0,0,0,0,0,1,1,2,2
Fiji,FJ,East Asia & Pacific,2019-11-01,passenger,711,313,2066,2379,3090,9392094.734132938,6,1,7,8,14
Fiji,FJ,East Asia & Pacific,2019-11-02,cargo,0,0,0,0,0,0,0,1,1,2,2
Fiji,FJ,East Asia & Pacific,2019-11-02,passenger,586,0,3236,3236,3822,10140557.660645647,5,0,11,11,16
Fiji,FJ,East Asia & Pacific,2019-11-03,cargo,0,0,0,0,0,0,0,0,1,1,1
Fiji,FJ,East Asia & Pacific,2019-11-03,passenger,793,708,3360,4068,4861,14738503.82172565,5,3,10,13,18
Fiji,FJ,East Asia & Pacific,2019-11-04,cargo,0,0,0,0,0,0,0,1,1,2,2
Fiji,FJ,East Asia & Pacific,2019-11-04,passenger,703,0,2513,2513,3216,7382385.929820853,6,0,9,9,15
Fiji,FJ,East Asia & Pacific,2019-11-05,cargo,0,0,0,0,0,0,0,0,1,1,1
Fiji,FJ,East Asia & Pacific,2019-11-05,passenger,575,0,2346,2346,2921,7970226.585077561,5,0,8,8,13
Fiji,FJ,East Asia & Pacific,2019-11-06,cargo,0,0,0,0,0,0,0,0,2,2,2
Fiji,FJ,East Asia & Pacific,2019-11-06,passenger,913,313,1958,2271,3184,7623341.504242234,5,1,9,10,15
Fiji,FJ,East Asia & Pacific,2019-11-07,cargo,0,0,0,0,0,0,0,1,1,2,2
Fiji,FJ,East Asia & Pacific,2019-11-07,passenger,872,0,2570,2570,3442,6936214.199390175,8,0,7,7,15
Fiji,FJ,East Asia & Pacific,2019-11-08,cargo,0,0,0,0,0,0,0,0,2,2,2
Fiji,FJ,East Asia & Pacific,2019-11-08,passenger,548,313,2248,2561,3109,9932827.813342737,6,1,6,7,13
Fiji,FJ,East Asia & Pacific,2019-11-09,cargo,0,0,0,0,0,0,0,0,2,2,2
Fiji,FJ,East Asia & Pacific,2019-11-09,passenger,581,273,3208,3481,4062,12701724.781945864,7,1,12,13,20
Fiji,FJ,East Asia & Pacific,2019-11-10,cargo,0,0,0,0,0,0,0,1,1,2,2
Fiji,FJ,East Asia & Pacific,2019-11-10,passenger,744,483,3750,4233,4977,14659799.374329668,5,2,10,12,17
Fiji,FJ,East Asia & Pacific,2019-11-11,cargo,0,0,0,0,0,0,0,1,2,3,3
Fiji,FJ,East Asia & Pacific,2019-11-11,passenger,608,0,2005,2005,2613,6281360.065099196,5,0,8,8,13
Fiji,FJ,East Asia & Pacific,2019-11-12,passenger,600,0,2885,2885,3485,9091116.486569269,4,0,7,7,11
Fiji,FJ,East Asia & Pacific,2019-11-13,cargo,0,0,0,0,0,0,0,0,1,1,1
Fiji,FJ,East Asia & Pacific,2019-11-13,passenger,765,313,2181,2494,3259,9793521.650374975,5,1,9,10,15
Fiji,FJ,East Asia & Pacific,2019-11-14,cargo,0,0,0,0,0,0,0,1,0,1,1
Fiji,FJ,East Asia & Pacific,2019-11-14,passenger,700,0,2688,2688,3388,7280687.2246656725,7,0,8,8,15
Fiji,FJ,East Asia & Pacific,2019-11-15,cargo,0,0,0,0,0,0,0,0,2,2,2
Fiji,FJ,East Asia & Pacific,2019-11-15,passenger,912,313,2248,2561,3473,9991965.694452628,9,1,6,7,16
Fiji,FJ,East Asia & Pacific,2019-11-16,cargo,0,0,0,0,0,0,0,0,2,2,2
Fiji,FJ,East Asia & Pacific,2019-11-16,passenger,1015,273,3550,3823,4838,13169529.70700596,11,1,13,14,25
Fiji,FJ,East Asia & Pacific,2019-11-17,cargo,0,0,0,0,0,0,0,1,1,2,2
Fiji,FJ,East Asia & Pacific,2019-11-17,passenger,1241,435,3582,4017,5258,14743070.29575696,8,2,10,12,20
Fiji,FJ,East Asia & Pacific,2019-11-18,cargo,0,0,0,0,0,0,0,1,1,2,2
Fiji,FJ,East Asia & Pacific,2019-11-18,passenger,1401,0,2519,2519,3920,7599527.192744517,15,0,10,10,25
Fiji,FJ,East Asia & Pacific,2019-11-19,cargo,0,0,0,0,0,0,0,1,1,2,2
Fiji,FJ,East Asia & Pacific,2019-11-19,passenger,1051,0,2469,2469,3520,6910666.7210125,11,0,7,7,18
Fiji,FJ,East Asia & Pacific,2019-11-20,cargo,0,0,0,0,0,0,0,0,1,1,1
Fiji,FJ,East Asia & Pacific,2019-11-20,passenger,1307,313,2571,2884,4191,10633145.355512043,9,1,12,13,22
Fiji,FJ,East Asia & Pacific,2019-11-21,cargo,0,0,0,0,0,0,0,1,1,2,2
Fiji,FJ,East Asia & Pacific,2019-11-21,passenger,1429,0,2469,2469,3898,6512589.635677695,11,0,9,9,20
Fiji,FJ,East Asia & Pacific,2019-11-22,cargo,0,0,0,0,0,0,0,0,2,2,2
Fiji,FJ,East Asia & Pacific,2019-11-22,passenger,1032,586,3091,3677,4709,14742347.341777977,8,2,8,10,18
Fiji,FJ,East Asia & Pacific,2019-11-23,cargo,0,0,0,0,0,0,0,1,1,2,2
Fiji,FJ,East Asia & Pacific,2019-11-23,passenger,1221,0,3102,3102,4323,9806166.680719964,13,0,11,11,24
Fiji,FJ,East Asia & Pacific,2019-11-24,cargo,0,0,0,0,0,0,0,0,2,2,2
Fiji,FJ,East Asia & Pacific,2019-11-24,passenger,1148,756,3644,4400,5548,15502955.808957838,9,3,10,13,22
Fiji,FJ,East Asia & Pacific,2019-11-25,cargo,0,0,0,0,0,0,0,1,1,2,2
Fiji,FJ,East Asia & Pacific,2019-11-25,passenger,1017,0,2830,2830,3847,10029521.416556459,13,0,10,10,23
Fiji,FJ,East Asia & Pacific,2019-11-26,passenger,952,273,2763,3036,3988,11244350.956137896,11,1,8,9,20
Fiji,FJ,East Asia & Pacific,2019-11-27,cargo,0,0,0,0,0,0,0,0,1,1,1
Fiji,FJ,East Asia & Pacific,2019-11-27,passenger,1115,313,2329,2642,3757,8467748.750122095,8,1,11,12,20
Fiji,FJ,East Asia & Pacific,2019-11-28,cargo,0,0,0,0,0,0,0,0,2,2,2
Fiji,FJ,East Asia & Pacific,2019-11-28,passenger,1380,273,2851,3124,4504,10377672.567741375,14,1,9,10,24
Fiji,FJ,East Asia & Pacific,2019-11-29,cargo,0,0,0,0,0,0,0,1,1,2,2
Fiji,FJ,East Asia & Pacific,2019-11-29,passenger,1080,313,2691,3004,4084,11354692.169062927,11,1,7,8,19
Fiji,FJ,East Asia & Pacific,2019-11-30,cargo,0,0,0,0,0,0,0,1,1,2,2
Fiji,FJ,East Asia & Pacific,2019-11-30,passenger,1072,0,3265,3265,4337,10247670.285998719,11,0,11,11,22
Fiji,FJ,East Asia & Pacific,2019-12-01,cargo,0,0,0,0,0,0,0,0,1,1,1
Fiji,FJ,East Asia & Pacific,2019-12-01,passenger,1246,750,3428,4178,5424,15375937.859223314,10,3,11,14,24
Fiji,FJ,East Asia & Pacific,2019-12-02,cargo,0,0,0,0,0,0,0,1,0,1,1
Fiji,FJ,East Asia & Pacific,2019-12-02,passenger,1131,0,3471,3471,4602,11993898.027281111,14,0,11,11,25
Fiji,FJ,East Asia & Pacific,2019-12-03,cargo,0,0,0,0,0,0,0,1,0,1,1
Fiji,FJ,East Asia & Pacific,2019-12-03,passenger,1180,0,2920,2920,4100,9058203.042158345,13,0,9,9,22
Fiji,FJ,East Asia & Pacific,2019-12-04,cargo,0,0,0,0,0,0,0,0,1,1,1
Fiji,FJ,East Asia & Pacific,2019-12-04,passenger,1321,586,2514,3100,4421,11992891.36093395,10,2,11,13,23
Fiji,FJ,East Asia & Pacific,2019-12-05,cargo,0,0,0,0,0,0,0,1,0,1,1
Fiji,FJ,East Asia & Pacific,2019-12-05,passenger,1537,0,3268,3268,4805,10603336.50388721,15,0,9,9,24
Fiji,FJ,East Asia & Pacific,2019-12-06,cargo,0,0,0,0,0,0,0,1,1,2,2
Fiji,FJ,East Asia & Pacific,2019-12-06,passenger,1221,313,2733,3046,4267,11665361.26105116,11,1,7,8,19
Fiji,FJ,East Asia & Pacific,2019-12-07,cargo,0,0,0,0,0,0,0,1,1,2,2
Fiji,FJ,East Asia & Pacific,2019-12-07,passenger,1115,0,3666,3666,4781,11298283.576440562,11,0,13,13,24
Fiji,FJ,East Asia & Pacific,2019-12-08,cargo,0,0,0,0,0,0,0,0,1,1,1
Fiji,FJ,East Asia & Pacific,2019-12-08,passenger,1474,750,3184,3934,5408,14862031.327537095,11,3,10,13,24
Fiji,FJ,East Asia & Pacific,2019-12-09,cargo,0,0,0,0,0,0,0,1,0,1,1
Fiji,FJ,East Asia & Pacific,2019-12-09,passenger,1088,0,3460,3460,4548,11968299.357479345,14,0,11,11,25
Fiji,FJ,East Asia & Pacific,2019-12-10,cargo,0,0,0,0,0,0,0,1,0,1,1
Fiji,FJ,East Asia & Pacific,2019-12-10,passenger,990,0,3520,3520,4510,11617123.203365834,11,0,10,10,21
Fiji,FJ,East Asia & Pacific,2019-12-11,cargo,0,0,0,0,0,0,0,1,1,2,2
Fiji,FJ,East Asia & Pacific,2019-12-11,passenger,1248,313,2849,3162,4410,10398136.53939049,10,1,11,12,22
Fiji,FJ,East Asia & Pacific,2019-12-12,cargo,0,0,0,0,0,0,0,0,2,2,2
Fiji,FJ,East Asia & Pacific,2019-12-12,passenger,1385,273,2802,3075,4460,10321473.3072421,12,1,9,10,22
Fiji,FJ,East Asia & Pacific,2019-12-13,cargo,0,0,0,0,0,0,0,1,0,1,1
Fiji,FJ,East Asia & Pacific,2019-12-13,passenger,1115,313,2555,2868,3983,10934959.380106868,12,1,7,8,20
Fiji,FJ,East Asia & Pacific,2019-12-14,cargo,0,0,0,0,0,0,0,1,1,2,2
Fiji,FJ,East Asia & Pacific,2019-12-14,passenger,1218,0,4651,4651,5869,13854271.207162123,13,0,12,12,25
Fiji,FJ,East Asia & Pacific,2019-12-15,cargo,0,0,0,0,0,0,0,0,1,1,1
Fiji,FJ,East Asia & Pacific,2019-12-15,passenger,1138,756,3059,3815,4953,14012826.847409716,7,3,11,14,21
Fiji,FJ,East Asia & Pacific,2019-12-16,cargo,0,0,0,0,0,0,0,1,1,2,2
Fiji,FJ,East Asia & Pacific,2019-12-16,passenger,1319,334,3742,4076,5395,15840629.544600286,17,1,11,12,29
Fiji,FJ,East Asia & Pacific,2019-12-17,cargo,0,0,0,0,0,0,0,0,1,1,1
Fiji,FJ,East Asia & Pacific,2019-12-17,passenger,1104,273,3586,3859,4963,13415611.867001556,12,1,9,10,22
Fiji,FJ,East Asia & Pacific,2019-12-18,cargo,0,0,0,0,0,0,0,1,0,1,1
Fiji,FJ,East Asia & Pacific,2019-12-18,passenger,1259,313,3553,3866,5125,13723399.701147111,11,1,12,13,24
Fiji,FJ,East Asia & Pacific,2019-12-19,cargo,0,0,0,0,0,0,0,2,1,3,3
Fiji,FJ,East Asia & Pacific,2019-12-19,passenger,1643,254,3285,3539,5182,12499187.327143379,16,1,10,11,27
Fiji,FJ,East Asia & Pacific,2019-12-20,cargo,0,0,0,0,0,0,0,2,0,2,2
Fiji,FJ,East Asia & Pacific,2019-12-20,passenger,1365,313,3510,3823,5188,13278528.31273273,12,1,8,9,21
Fiji,FJ,East Asia & Pacific,2019-12-21,cargo,0,0,0,0,0,0,0,0,1,1,1
Fiji,FJ,East Asia & Pacific,2019-12-21,passenger,1026,273,5350,5623,6649,18205815.16175299,11,1,14,15,26
Fiji,FJ,East Asia & Pacific,2019-12-22,cargo,0,0,0,0,0,0,0,1,1,2,2
Fiji,FJ,East Asia & Pacific,2019-12-22,passenger,1428,477,3951,4428,5856,16208185.81464176,9,2,12,14,23
Fiji,FJ,East Asia & Pacific,2019-12-23,cargo,0,0,0,0,0,0,0,0,2,2,2
Fiji,FJ,East Asia & Pacific,2019-12-23,passenger,1414,334,3637,3971,5385,15537094.076858917,15,1,10,11,26
Fiji,FJ,East Asia & Pacific,2019-12-24,cargo,0,0,0,0,0,0,0,1,0,1,1
Fiji,FJ,East Asia & Pacific,2019-12-24,passenger,1199,0,3587,3587,4786,11029265.44835771,15,0,8,8,23
Fiji,FJ,East Asia & Pacific,2019-12-25,cargo,0,0,0,0,0,0,0,0,2,2,2
Fiji,FJ,East Asia & Pacific,2019-12-25,passenger,1169,647,2510,3157,4326,12519388.222155083,9,2,12,14,23
Fiji,FJ,East Asia & Pacific,2019-12-26,cargo,0,0,0,0,0,0,0,1,1,2,2
Fiji,FJ,East Asia & Pacific,2019-12-26,passenger,915,0,2842,2842,3757,7907843.384542331,8,0,8,8,16
Fiji,FJ,East Asia & Pacific,2019-12-27,passenger,0,0,354,354,354,1122114.340425273,0,0,1,1,1
Fiji,FJ,East Asia & Pacific,2019-12-28,cargo,0,0,0,0,0,0,0,0,1,1,1
Fiji,FJ,East Asia & Pacific,2019-12-28,passenger,573,334,2672,3006,3579,11094683.297503935,8,1,4,5,13
Fiji,FJ,East Asia & Pacific,2019-12-29,cargo,0,0,0,0,0,0,0,1,1,2,2
Fiji,FJ,East Asia & Pacific,2019-12-29,passenger,1236,756,4257,5013,6249,19772692.65170831,10,3,12,15,25
Fiji,FJ,East Asia & Pacific,2019-12-30,cargo,0,0,0,0,0,0,0,1,1,2,2
Fiji,FJ,East Asia & Pacific,2019-12-30,passenger,1354,0,4260,4260,5614,14187978.40395258,15,0,11,11,26
Fiji,FJ,East Asia & Pacific,2019-12-31,cargo,0,0,0,0,0,0,0,0,2,2,2
Fiji,FJ,East Asia & Pacific,2019-12-31,passenger,1256,334,2746,3080,4336,11858782.881241042,16,1,8,9,25
Fiji,FJ,East Asia & Pacific,2020-01-01,cargo,0,0,0,0,0,0,0,0,2,2,2
Fiji,FJ,East Asia & Pacific,2020-01-01,passenger,1424,586,3010,3596,5020,12941402.026591966,14,2,9,11,25
Fiji,FJ,East Asia & Pacific,2020-01-02,cargo,0,0,0,0,0,0,0,0,2,2,2
Fiji,FJ,East Asia & Pacific,2020-01-02,passenger,1638,334,3081,3415,5053,11556585.283003483,14,1,9,10,24
Fiji,FJ,East Asia & Pacific,2020-01-03,cargo,0,0,0,0,0,0,0,1,1,2,2
Fiji,FJ,East Asia & Pacific,2020-01-03,passenger,1240,313,2820,3133,4373,11310762.801143067,12,1,7,8,20
Fiji,FJ,East Asia & Pacific,2020-01-04,cargo,0,0,0,0,0,0,0,0,2,2,2
Fiji,FJ,East Asia & Pacific,2020-01-04,passenger,1191,334,4107,4441,5632,15038164.111881522,13,1,13,14,27
Fiji,FJ,East Asia & Pacific,2020-01-05,cargo,0,0,0,0,0,0,0,0,2,2,2
Fiji,FJ,East Asia & Pacific,2020-01-05,passenger,1167,750,3697,4447,5614,17052332.279846575,10,3,12,15,25
Fiji,FJ,East Asia & Pacific,2020-01-06,cargo,0,0,0,0,0,0,0,0,1,1,1
Fiji,FJ,East Asia & Pacific,2020-01-06,passenger,936,334,3488,3822,4758,15304003.489019876,11,1,11,12,23
Fiji,FJ,East Asia & Pacific,2020-01-07,cargo,0,0,0,0,0,0,0,1,0,1,1
Fiji,FJ,East Asia & Pacific,2020-01-07,passenger,1128,0,3175,3175,4303,9958662.32079954,15,0,9,9,24
Fiji,FJ,East Asia & Pacific,2020-01-08,cargo,0,0,0,0,0,0,0,0,1,1,1
Fiji,FJ,East Asia & Pacific,2020-01-08,passenger,504,586,3209,3795,4299,13609594.571482234,8,2,11,13,21
Fiji,FJ,East Asia & Pacific,2020-01-09,cargo,0,0,0,0,0,0,0,1,0,1,1
Fiji,FJ,East Asia & Pacific,2020-01-09,passenger,853,0,3232,3232,4085,10439698.246452194,12,0,9,9,21
Fiji,FJ,East Asia & Pacific,2020-01-10,cargo,0,0,0,0,0,0,0,1,1,2,2
Fiji,FJ,East Asia & Pacific,2020-01-10,passenger,1275,334,2703,3037,4312,11871179.604157235,13,1,7,8,21
Fiji,FJ,East Asia & Pacific,2020-01-11,cargo,0,0,0,0,0,0,0,0,2,2,2
Fiji,FJ,East Asia & Pacific,2020-01-11,passenger,1031,334,4109,4443,5474,15040763.228676554,11,1,11,12,23
Fiji,FJ,East Asia & Pacific,2020-01-12,cargo,0,0,0,0,0,0,0,1,0,1,1
Fiji,FJ,East Asia & Pacific,2020-01-12,passenger,1327,504,4000,4504,5831,16527379.545729846,13,2,13,15,28
Fiji,FJ,East Asia & Pacific,2020-01-13,cargo,0,0,0,0,0,0,0,1,1,2,2
Fiji,FJ,East Asia & Pacific,2020-01-13,passenger,1025,0,3005,3005,4030,9259453.910120204,13,0,10,10,23
Fiji,FJ,East Asia & Pacific,2020-01-14,cargo,0,0,0,0,0,0,0,0,1,1,1
Fiji,FJ,East Asia & Pacific,2020-01-14,passenger,1147,334,3238,3572,4719,12866481.964694384,17,1,8,9,26
Fiji,FJ,East Asia & Pacific,2020-01-15,cargo,0,0,0,0,0,0,0,1,1,2,2
Fiji,FJ,East Asia & Pacific,2020-01-15,passenger,1036,273,3064,3337,4373,10460209.56440551,12,1,11,12,24
Fiji,FJ,East Asia & Pacific,2020-01-16,cargo,0,0,0,0,0,0,0,0,2,2,2
Fiji,FJ,East Asia & Pacific,2020-01-16,passenger,1200,334,2856,3190,4390,10132147.740605144,12,1,9,10,22
Fiji,FJ,East Asia & Pacific,2020-01-17,cargo,0,0,0,0,0,0,0,1,1,2,2
Fiji,FJ,East Asia & Pacific,2020-01-17,passenger,931,273,2690,2963,3894,10746340.912171477,10,1,5,6,16
Fiji,FJ,East Asia & Pacific,2020-01-18,cargo,0,0,0,0,0,0,0,0,1,1,1
Fiji,FJ,East Asia & Pacific,2020-01-18,passenger,1281,334,4767,5101,6382,18544190.158410415,14,1,10,11,25
Fiji,FJ,East Asia & Pacific,2020-01-19,cargo,0,0,0,0,0,0,0,0,1,1,1
Fiji,FJ,East Asia & Pacific,2020-01-19,passenger,1466,811,3093,3904,5370,15140507.99077767,15,3,10,13,28
Fiji,FJ,East Asia & Pacific,2020-01-20,cargo,0,0,0,0,0,0,0,0,1,1,1
Fiji,FJ,East Asia & Pacific,2020-01-20,passenger,938,334,3849,4183,5121,15323756.681422576,13,1,15,16,29
Fiji,FJ,East Asia & Pacific,2020-01-21,cargo,0,0,0,0,0,0,0,0,1,1,1
Fiji,FJ,East Asia & Pacific,2020-01-21,passenger,1209,334,2743,3077,4286,10745272.589758156,15,1,9,10,25
Fiji,FJ,East Asia & Pacific,2020-01-22,cargo,0,0,0,0,0,0,0,1,1,2,2
Fiji,FJ,East Asia & Pacific,2020-01-22,passenger,1093,334,2918,3252,4345,13633731.743133208,12,1,12,13,25
Fiji,FJ,East Asia & Pacific,2020-01-23,cargo,0,0,0,0,0,0,0,0,2,2,2
Fiji,FJ,East Asia & Pacific,2020-01-23,passenger,1379,334,2543,2877,4256,11659479.77618401,14,1,10,11,25
Fiji,FJ,East Asia & Pacific,2020-01-24,cargo,0,0,0,0,0,0,0,2,1,3,3
Fiji,FJ,East Asia & Pacific,2020-01-24,passenger,982,0,2616,2616,3598,7149618.327739072,10,0,6,6,16
Fiji,FJ,East Asia & Pacific,2020-01-25,cargo,0,0,0,0,0,0,0,0,3,3,3
Fiji,FJ,East Asia & Pacific,2020-01-25,passenger,1123,334,3451,3785,4908,13775952.812232943,10,1,12,13,23
Fiji,FJ,East Asia & Pacific,2020-01-26,cargo,0,0,0,0,0,0,0,2,0,2,2
Fiji,FJ,East Asia & Pacific,2020-01-26,passenger,1235,122,3672,3794,5029,11916153.21431767,12,1,14,15,27
Fiji,FJ,East Asia & Pacific,2020-01-27,cargo,0,0,0,0,0,0,0,0,2,2,2
Fiji,FJ,East Asia & Pacific,2020-01-27,passenger,892,334,2589,2923,3815,11305394.4609588,13,1,10,11,24
Fiji,FJ,East Asia & Pacific,2020-01-28,cargo,0,0,0,0,0,0,0,1,1,2,2
Fiji,FJ,East Asia & Pacific,2020-01-28,passenger,840,0,2519,2519,3359,7733181.022422825,14,0,9,9,23
Fiji,FJ,East Asia & Pacific,2020-01-29,cargo,0,0,0,0,0,0,0,0,2,2,2
Fiji,FJ,East Asia & Pacific,2020-01-29,passenger,1139,607,2215,2822,3961,12913591.870886624,12,2,11,13,25
Fiji,FJ,East Asia & Pacific,2020-01-30,cargo,0,0,0,0,0,0,0,1,1,2,2
Fiji,FJ,East Asia & Pacific,2020-01-30,passenger,1159,0,3135,3135,4294,11380532.31148682,13,0,10,10,23
Fiji,FJ,East Asia & Pacific,2020-01-31,cargo,0,0,0,0,0,0,0,0,3,3,3
Fiji,FJ,East Asia & Pacific,2020-01-31,passenger,1172,334,2135,2469,3641,9584526.411056204,13,1,7,8,21
Fiji,FJ,East Asia & Pacific,2020-02-01,cargo,0,0,0,0,0,0,0,2,1,3,3
Fiji,FJ,East Asia & Pacific,2020-02-01,passenger,903,0,3638,3638,4541,13195137.772076843,10,0,12,12,22
Fiji,FJ,East Asia & Pacific,2020-02-02,cargo,0,0,0,0,0,0,0,1,2,3,3
Fiji,FJ,East Asia & Pacific,2020-02-02,passenger,1082,498,2978,3476,4558,13602705.674965568,11,2,13,15,26
Fiji,FJ,East Asia & Pacific,2020-02-03,cargo,0,0,0,0,0,0,0,1,2,3,3
Fiji,FJ,East Asia & Pacific,2020-02-03,passenger,1041,0,1881,1881,2922,5631882.823202309,14,0,9,9,23
Fiji,FJ,East Asia & Pacific,2020-02-04,cargo,0,0,0,0,0,0,0,0,2,2,2
Fiji,FJ,East Asia & Pacific,2020-02-04,passenger,924,334,1819,2153,3077,9051009.95618899,13,1,9,10,23
Fiji,FJ,East Asia & Pacific,2020-02-05,cargo,0,0,0,0,0,0,0,1,1,2,2
Fiji,FJ,East Asia & Pacific,2020-02-05,passenger,940,0,2131,2131,3071,5010955.456595023,10,0,8,8,18
Fiji,FJ,East Asia & Pacific,2020-02-06,cargo,0,0,0,0,0,0,0,0,2,2,2
Fiji,FJ,East Asia & Pacific,2020-02-06,passenger,1169,334,1475,1809,2978,8692850.006747413,11,1,8,9,20
Fiji,FJ,East Asia & Pacific,2020-02-07,cargo,0,0,0,0,0,0,0,2,1,3,3
Fiji,FJ,East Asia & Pacific,2020-02-07,passenger,1096,0,2304,2304,3400,7555548.023285155,11,0,5,5,16
Fiji,FJ,East Asia & Pacific,2020-02-08,cargo,0,0,0,0,0,0,0,0,3,3,3
Fiji,FJ,East Asia & Pacific,2020-02-08,passenger,990,334,2837,3171,4161,11502556.561548056,8,1,11,12,20
Fiji,FJ,East Asia & Pacific,2020-02-09,cargo,0,0,0,0,0,0,0,1,1,2,2
Fiji,FJ,East Asia & Pacific,2020-02-09,passenger,1139,653,2829,3482,4621,12255906.107308099,11,2,12,14,25
Fiji,FJ,East Asia & Pacific,2020-02-10,cargo,0,0,0,0,0,0,0,0,3,3,3
Fiji,FJ,East Asia & Pacific,2020-02-10,passenger,1041,334,1719,2053,3094,7316415.818121336,11,1,7,8,19
Fiji,FJ,East Asia & Pacific,2020-02-11,cargo,0,0,0,0,0,0,0,1,3,4,4
Fiji,FJ,East Asia & Pacific,2020-02-11,passenger,859,0,1462,1462,2321,4075963.207547517,13,0,7,7,20
Fiji,FJ,East Asia & Pacific,2020-02-12,cargo,0,0,0,0,0,0,0,1,0,1,1
Fiji,FJ,East Asia & Pacific,2020-02-12,passenger,930,0,2485,2485,3415,6377920.209480501,11,0,8,8,19
Fiji,FJ,East Asia & Pacific,2020-02-13,cargo,0,0,0,0,0,0,0,1,1,2,2
Fiji,FJ,East Asia & Pacific,2020-02-13,passenger,1357,0,2090,2090,3447,5467121.109538887,12,0,7,7,19
Fiji,FJ,East Asia & Pacific,2020-02-14,cargo,0,0,0,0,0,0,0,1,2,3,3
Fiji,FJ,East Asia & Pacific,2020-02-14,passenger,1004,273,1807,2080,3084,6814463.260521041,10,1,6,7,17
Fiji,FJ,East Asia & Pacific,2020-02-15,cargo,0,0,0,0,0,0,0,1,3,4,4
Fiji,FJ,East Asia & Pacific,2020-02-15,passenger,952,0,2692,2692,3644,8595370.925490271,9,0,10,10,19
Fiji,FJ,East Asia & Pacific,2020-02-16,cargo,0,0,0,0,0,0,0,1,2,3,3
Fiji,FJ,East Asia & Pacific,2020-02-16,passenger,1248,477,2558,3035,4283,10297723.922670703,11,2,10,12,23
Fiji,FJ,East Asia & Pacific,2020-02-17,cargo,0,0,0,0,0,0,0,1,3,4,4
Fiji,FJ,East Asia & Pacific,2020-02-17,passenger,1044,0,1078,1078,2122,2460151.8602172974,11,0,6,6,17
Fiji,FJ,East Asia & Pacific,2020-02-18,cargo,0,0,0,0,0,0,0,1,3,4,4
Fiji,FJ,East Asia & Pacific,2020-02-18,passenger,905,0,1192,1192,2097,3587116.754767079,12,0,5,5,17
Fiji,FJ,East Asia & Pacific,2020-02-19,cargo,0,0,0,0,0,0,0,1,1,2,2
Fiji,FJ,East Asia & Pacific,2020-02-19,passenger,756,0,2555,2555,3311,6579036.655564479,10,0,8,8,18
Fiji,FJ,East Asia & Pacific,2020-02-20,cargo,0,0,0,0,0,0,0,1,2,3,3
Fiji,FJ,East Asia & Pacific,2020-02-20,passenger,689,0,1754,1754,2443,4604387.962064701,8,0,5,5,13
Fiji,FJ,East Asia & Pacific,2020-02-21,cargo,0,0,0,0,0,0,0,1,3,4,4
Fiji,FJ,East Asia & Pacific,2020-02-21,passenger,510,273,1662,1935,2445,7239431.444971345,6,1,5,6,12
Fiji,FJ,East Asia & Pacific,2020-02-22,cargo,0,0,0,0,0,0,0,1,3,4,4
Fiji,FJ,East Asia & Pacific,2020-02-22,passenger,445,0,2587,2587,3032,7994119.388116837,4,0,10,10,14
Fiji,FJ,East Asia & Pacific,2020-02-23,cargo,0,0,0,0,0,0,0,1,2,3,3
Fiji,FJ,East Asia & Pacific,2020-02-23,passenger,847,483,1834,2317,3164,8411996.696016718,7,2,8,10,17
Fiji,FJ,East Asia & Pacific,2020-02-24,cargo,0,0,0,0,0,0,0,1,2,3,3
Fiji,FJ,East Asia & Pacific,2020-02-24,passenger,628,0,1815,1815,2443,4358027.844047304,7,0,8,8,15
Fiji,FJ,East Asia & Pacific,2020-02-25,cargo,0,0,0,0,0,0,0,1,2,3,3
Fiji,FJ,East Asia & Pacific,2020-02-25,passenger,772,0,1915,1915,2687,5086543.249648859,9,0,7,7,16
Fiji,FJ,East Asia & Pacific,2020-02-26,cargo,0,0,0,0,0,0,0,1,1,2,2
Fiji,FJ,East Asia & Pacific,2020-02-26,passenger,589,0,2129,2129,2718,5460898.098840119,6,0,10,10,16
Fiji,FJ,East Asia & Pacific,2020-02-27,cargo,0,0,0,0,0,0,0,1,3,4,4
Fiji,FJ,East Asia & Pacific,2020-02-27,passenger,700,0,1538,1538,2238,4068097.174756661,9,0,6,6,15
Fiji,FJ,East Asia & Pacific,2020-02-28,cargo,0,0,0,0,0,0,0,2,2,4,4
Fiji,FJ,East Asia & Pacific,2020-02-28,passenger,592,0,1691,1691,2283,5020186.320438075,5,0,4,4,9
Fiji,FJ,East Asia & Pacific,2020-02-29,cargo,0,0,0,0,0,0,0,1,3,4,4
Fiji,FJ,East Asia & Pacific,2020-02-29,passenger,611,0,2745,2745,3356,7169310.063760596,4,0,10,10,14
Fiji,FJ,East Asia & Pacific,2020-03-01,cargo,0,0,0,0,0,0,0,1,2,3,3
Fiji,FJ,East Asia & Pacific,2020-03-01,passenger,548,164,2000,2164,2712,5791181.319825907,6,1,9,10,16
Fiji,FJ,East Asia & Pacific,2020-03-02,cargo,0,0,0,0,0,0,0,1,2,3,3
Fiji,FJ,East Asia & Pacific,2020-03-02,passenger,531,0,2005,2005,2536,6114280.708451182,7,0,10,10,17
Fiji,FJ,East Asia & Pacific,2020-03-03,cargo,0,0,0,0,0,0,0,1,1,2,2
Fiji,FJ,East Asia & Pacific,2020-03-03,passenger,458,0,1936,1936,2394,6320944.124566448,5,0,8,8,13
Fiji,FJ,East Asia & Pacific,2020-03-04,cargo,0,0,0,0,0,0,0,1,1,2,2
Fiji,FJ,East Asia & Pacific,2020-03-04,passenger,428,0,1613,1613,2041,4063658.8595013055,4,0,6,6,10
Fiji,FJ,East Asia & Pacific,2020-03-05,cargo,0,0,0,0,0,0,0,1,2,3,3
Fiji,FJ,East Asia & Pacific,2020-03-05,passenger,529,0,2002,2002,2531,5201056.870120849,7,0,6,6,13
Fiji,FJ,East Asia & Pacific,2020-03-06,cargo,0,0,0,0,0,0,0,1,2,3,3
Fiji,FJ,East Asia & Pacific,2020-03-06,passenger,529,273,1826,2099,2628,7588504.421956708,5,1,5,6,11
Fiji,FJ,East Asia & Pacific,2020-03-07,cargo,0,0,0,0,0,0,0,1,3,4,4
Fiji,FJ,East Asia & Pacific,2020-03-07,passenger,355,0,2477,2477,2832,8020970.470264707,4,0,9,9,13
Fiji,FJ,East Asia & Pacific,2020-03-08,cargo,0,0,0,0,0,0,0,2,1,3,3
Fiji,FJ,East Asia & Pacific,2020-03-08,passenger,887,164,1923,2087,2974,5822470.519338787,9,1,10,11,20
Fiji,FJ,East Asia & Pacific,2020-03-09,cargo,0,0,0,0,0,0,0,1,2,3,3
Fiji,FJ,East Asia & Pacific,2020-03-09,passenger,949,0,1887,1887,2836,4168272.3486833046,9,0,8,8,17
Fiji,FJ,East Asia & Pacific,2020-03-10,cargo,0,0,0,0,0,0,0,1,2,3,3
Fiji,FJ,East Asia & Pacific,2020-03-10,passenger,924,0,1382,1382,2306,3982457.9503755067,13,0,7,7,20
Fiji,FJ,East Asia & Pacific,2020-03-11,cargo,0,0,0,0,0,0,0,1,0,1,1
Fiji,FJ,East Asia & Pacific,2020-03-11,passenger,965,0,2490,2490,3455,6677881.981593682,11,0,7,7,18
Fiji,FJ,East Asia & Pacific,2020-03-12,cargo,0,0,0,0,0,0,0,1,3,4,4
Fiji,FJ,East Asia & Pacific,2020-03-12,passenger,1372,0,1504,1504,2876,3888297.750433442,14,0,7,7,21
Fiji,FJ,East Asia & Pacific,2020-03-13,cargo,0,0,0,0,0,0,0,1,2,3,3
Fiji,FJ,East Asia & Pacific,2020-03-13,passenger,1080,313,1836,2149,3229,7996306.901117138,13,1,5,6,19
Fiji,FJ,East Asia & Pacific,2020-03-14,cargo,0,0,0,0,0,0,0,1,3,4,4
Fiji,FJ,East Asia & Pacific,2020-03-14,passenger,879,0,2991,2991,3870,9536308.544065924,7,0,11,11,18
Fiji,FJ,East Asia & Pacific,2020-03-15,cargo,0,0,0,0,0,0,0,2,2,4,4
Fiji,FJ,East Asia & Pacific,2020-03-15,passenger,1028,170,2748,2918,3946,8069237.853566472,9,1,10,11,20
Fiji,FJ,East Asia & Pacific,2020-03-16,cargo,0,0,0,0,0,0,0,1,2,3,3
Fiji,FJ,East Asia & Pacific,2020-03-16,passenger,889,0,1991,1991,2880,4324939.213665056,11,0,9,9,20
Fiji,FJ,East Asia & Pacific,2020-03-17,cargo,0,0,0,0,0,0,0,1,2,3,3
Fiji,FJ,East Asia & Pacific,2020-03-17,passenger,845,0,1255,1255,2100,3950584.507656774,11,0,5,5,16
Fiji,FJ,East Asia & Pacific,2020-03-18,cargo,0,0,0,0,0,0,0,1,1,2,2
Fiji,FJ,East Asia & Pacific,2020-03-18,passenger,794,0,3001,3001,3795,8260066.345240479,10,0,9,9,19
Fiji,FJ,East Asia & Pacific,2020-03-19,cargo,0,0,0,0,0,0,0,1,2,3,3
Fiji,FJ,East Asia & Pacific,2020-03-19,passenger,697,0,1634,1634,2331,5618316.408085214,8,0,4,4,12
Fiji,FJ,East Asia & Pacific,2020-03-20,cargo,0,0,0,0,0,0,0,1,2,3,3
Fiji,FJ,East Asia & Pacific,2020-03-20,passenger,461,0,1036,1036,1497,3236315.035196572,5,0,3,3,8
Fiji,FJ,East Asia & Pacific,2020-03-21,cargo,0,0,0,0,0,0,0,1,2,3,3
Fiji,FJ,East Asia & Pacific,2020-03-21,passenger,423,0,1551,1551,1974,4363124.425703561,4,0,6,6,10
Fiji,FJ,East Asia & Pacific,2020-03-22,cargo,0,0,0,0,0,0,0,1,1,2,2
Fiji,FJ,East Asia & Pacific,2020-03-22,passenger,518,170,1238,1408,1926,4298828.720739633,6,1,3,4,10
Fiji,FJ,East Asia & Pacific,2020-03-23,cargo,0,0,0,0,0,0,0,1,0,1,1
Fiji,FJ,East Asia & Pacific,2020-03-23,passenger,463,0,437,437,900,2862406.360624143,7,0,2,2,9
Fiji,FJ,East Asia & Pacific,2020-03-24,cargo,0,0,0,0,0,0,0,1,0,1,1
Fiji,FJ,East Asia & Pacific,2020-03-24,passenger,557,0,692,692,1249,1856162.2494459609,8,0,3,3,11
Fiji,FJ,East Asia & Pacific,2020-03-25,passenger,766,313,122,435,1201,3055450.4268348147,9,1,1,2,11
Fiji,FJ,East Asia & Pacific,2020-03-26,passenger,437,0,0,0,437,69170.02184739005,7,0,0,0,7
Fiji,FJ,East Asia & Pacific,2020-03-27,passenger,415,0,0,0,415,73418.27448157844,9,0,0,0,9
Fiji,FJ,East Asia & Pacific,2020-03-28,passenger,348,0,80,80,428,281095.46391922823,5,0,1,1,6
Fiji,FJ,East Asia & Pacific,2020-03-29,passenger,320,0,312,312,632,723571.4270329026,4,0,1,1,5
Fiji,FJ,East Asia & Pacific,2020-03-30,passenger,84,0,0,0,84,10268.744579771177,3,0,0,0,3
Fiji,FJ,East Asia & Pacific,2020-03-31,passenger,38,0,164,164,202,449558.84045415826,2,0,1,1,3
Fiji,FJ,East Asia & Pacific,2020-04-01,passenger,38,0,0,0,38,4654.072265907837,2,0,0,0,2
Fiji,FJ,East Asia & Pacific,2020-04-02,passenger,19,0,0,0,19,2327.0361329539187,1,0,0,0,1
Fiji,FJ,East Asia & Pacific,2020-04-04,cargo,0,0,0,0,0,0,0,0,1,1,1
Fiji,FJ,East Asia & Pacific,2020-04-04,passenger,0,0,300,300,300,473653.03830569325,0,0,2,2,2
Fiji,FJ,East Asia & Pacific,2020-04-05,cargo,0,0,0,0,0,0,0,0,1,1,1
Fiji,FJ,East Asia & Pacific,2020-04-09,passenger,0,0,254,254,254,545917.4449274489,0,0,1,1,1
Fiji,FJ,East Asia & Pacific,2020-04-10,cargo,0,0,0,0,0,0,0,1,0,1,1
Fiji,FJ,East Asia & Pacific,2020-04-10,passenger,0,0,586,586,586,1714476.39131726,0,0,2,2,2
Fiji,FJ,East Asia & Pacific,2020-04-16,passenger,19,0,0,0,19,2327.0361329539187,1,0,0,0,1
Fiji,FJ,East Asia & Pacific,2020-04-17,cargo,0,0,0,0,0,0,0,0,1,1,1
Fiji,FJ,East Asia & Pacific,2020-04-17,passenger,19,0,0,0,19,2327.0361329539187,1,0,0,0,1
Fiji,FJ,East Asia & Pacific,2020-04-19,cargo,0,0,0,0,0,0,0,1,0,1,1
Fiji,FJ,East Asia & Pacific,2020-04-19,passenger,19,0,0,0,19,2327.0361329539187,1,0,0,0,1
Fiji,FJ,East Asia & Pacific,2020-04-20,cargo,0,0,0,0,0,0,0,0,1,1,1
Fiji,FJ,East Asia & Pacific,2020-04-20,passenger,38,0,275,275,313,595706.4240574371,2,0,1,1,3
Fiji,FJ,East Asia & Pacific,2020-04-21,passenger,38,0,0,0,38,4654.072265907837,2,0,0,0,2
Fiji,FJ,East Asia & Pacific,2020-04-22,passenger,38,0,0,0,38,4654.072265907837,2,0,0,0,2
Fiji,FJ,East Asia & Pacific,2020-04-23,cargo,0,0,0,0,0,0,0,0,1,1,1
Fiji,FJ,East Asia & Pacific,2020-04-23,passenger,84,0,275,275,359,601340.3010109045,2,0,1,1,3
Fiji,FJ,East Asia & Pacific,2020-04-24,cargo,0,0,0,0,0,0,0,0,1,1,1
Fiji,FJ,East Asia & Pacific,2020-04-24,passenger,95,0,68,68,163,155888.71829191933,3,0,1,1,4
Fiji,FJ,East Asia & Pacific,2020-04-25,cargo,0,0,0,0,0,0,0,0,1,1,1
Fiji,FJ,East Asia & Pacific,2020-04-25,passenger,95,0,0,0,95,11635.180664769594,2,0,0,0,2
Fiji,FJ,East Asia & Pacific,2020-04-26,cargo,0,0,0,0,0,0,0,1,0,1,1
Fiji,FJ,East Asia & Pacific,2020-04-26,passenger,103,0,0,0,103,12979.729242065445,4,0,0,0,4
Fiji,FJ,East Asia & Pacific,2020-04-27,cargo,0,0,0,0,0,0,0,0,1,1,1
Fiji,FJ,East Asia & Pacific,2020-04-27,passenger,261,0,0,0,261,44279.362271076345,4,0,0,0,4
Fiji,FJ,East Asia & Pacific,2020-04-28,passenger,399,0,0,0,399,66161.68493424397,9,0,0,0,9
Fiji,FJ,East Asia & Pacific,2020-04-29,passenger,394,0,0,0,394,60743.51128919695,7,0,0,0,7
Fiji,FJ,East Asia & Pacific,2020-04-30,cargo,0,0,0,0,0,0,0,0,1,1,1
Fiji,FJ,East Asia & Pacific,2020-04-30,passenger,288,0,164,164,452,680044.2794811645,6,0,1,1,7
Fiji,FJ,East Asia & Pacific,2020-05-01,cargo,0,0,0,0,0,0,0,0,2,2,2
Fiji,FJ,East Asia & Pacific,2020-05-01,passenger,261,0,0,0,261,38701.31915689328,4,0,0,0,4
Fiji,FJ,East Asia & Pacific,2020-05-02,passenger,209,0,0,0,209,36309.17571604228,6,0,0,0,6
Fiji,FJ,East Asia & Pacific,2020-05-03,cargo,0,0,0,0,0,0,0,1,0,1,1
Fiji,FJ,East Asia & Pacific,2020-05-03,passenger,386,0,0,0,386,56802.3801538852,6,0,0,0,6
Fiji,FJ,East Asia & Pacific,2020-05-04,cargo,0,0,0,0,0,0,0,1,1,2,2
Fiji,FJ,East Asia & Pacific,2020-05-04,passenger,367,0,0,0,367,58418.8498785346,7,0,0,0,7
Fiji,FJ,East Asia & Pacific,2020-05-05,cargo,0,0,0,0,0,0,0,0,1,1,1
Fiji,FJ,East Asia & Pacific,2020-05-05,passenger,326,0,0,0,326,49306.75966293425,7,0,0,0,7
Fiji,FJ,East Asia & Pacific,2020-05-06,passenger,266,0,0,0,266,48083.14806772725,8,0,0,0,8
Fiji,FJ,East Asia & Pacific,2020-05-07,cargo,0,0,0,0,0,0,0,1,1,2,2
Fiji,FJ,East Asia & Pacific,2020-05-07,passenger,451,0,0,0,451,68429.79197046829,9,0,0,0,9
Fiji,FJ,East Asia & Pacific,2020-05-08,cargo,0,0,0,0,0,0,0,0,2,2,2
Fiji,FJ,East Asia & Pacific,2020-05-08,passenger,427,0,0,0,427,90471.45343707803,5,0,0,0,5
Fiji,FJ,East Asia & Pacific,2020-05-09,passenger,144,0,0,0,144,18358.413962008075,3,0,0,0,3
Fiji,FJ,East Asia & Pacific,2020-05-10,cargo,0,0,0,0,0,0,0,1,0,1,1
Fiji,FJ,East Asia & Pacific,2020-05-10,passenger,337,0,0,0,337,45009.20316259619,6,0,0,0,6
Fiji,FJ,East Asia & Pacific,2020-05-11,cargo,0,0,0,0,0,0,0,0,1,1,1
Fiji,FJ,East Asia & Pacific,2020-05-11,passenger,299,0,0,0,299,45278.44144185122,6,0,0,0,6
Fiji,FJ,East Asia & Pacific,2020-05-12,passenger,421,0,0,0,421,70899.84440340791,11,0,0,0,11
Fiji,FJ,East Asia & Pacific,2020-05-13,cargo,0,0,0,0,0,0,0,0,1,1,1
Fiji,FJ,East Asia & Pacific,2020-05-13,passenger,356,0,0,0,356,59125.15544237617,7,0,0,0,7
Fiji,FJ,East Asia & Pacific,2020-05-14,passenger,296,0,0,0,296,42710.88492373897,7,0,0,0,7
Fiji,FJ,East Asia & Pacific,2020-05-15,cargo,0,0,0,0,0,0,0,0,2,2,2
Fiji,FJ,East Asia & Pacific,2020-05-15,passenger,514,0,165,165,679,489120.55013536575,7,0,1,1,8
Fiji,FJ,East Asia & Pacific,2020-05-16,cargo,0,0,0,0,0,0,0,1,2,3,3
Fiji,FJ,East Asia & Pacific,2020-05-16,passenger,427,0,0,0,427,62643.14196928147,5,0,0,0,5
Fiji,FJ,East Asia & Pacific,2020-05-17,cargo,0,0,0,0,0,0,0,1,1,2,2
Fiji,FJ,East Asia & Pacific,2020-05-17,passenger,291,0,0,0,291,33313.35937702452,3,0,0,0,3
Fiji,FJ,East Asia & Pacific,2020-05-18,cargo,0,0,0,0,0,0,0,0,1,1,1
Fiji,FJ,East Asia & Pacific,2020-05-18,passenger,291,0,0,0,291,33313.35937702452,3,0,0,0,3
Fiji,FJ,East Asia & Pacific,2020-05-19,cargo,0,0,0,0,0,0,0,0,1,1,1
Fiji,FJ,East Asia & Pacific,2020-05-19,passenger,204,0,0,0,204,24985.01953276839,2,0,0,0,2
Fiji,FJ,East Asia & Pacific,2020-05-20,cargo,0,0,0,0,0,0,0,1,1,2,2
Fiji,FJ,East Asia & Pacific,2020-05-20,passenger,288,0,0,0,288,32945.93261918969,3,0,0,0,3
Fiji,FJ,East Asia & Pacific,2020-05-21,cargo,0,0,0,0,0,0,0,1,0,1,1
Fiji,FJ,East Asia & Pacific,2020-05-21,passenger,298,0,0,0,298,73673.10056818253,4,0,0,0,4
Fiji,FJ,East Asia & Pacific,2020-05-22,cargo,0,0,0,0,0,0,0,1,1,2,2
Fiji,FJ,East Asia & Pacific,2020-05-22,passenger,386,0,165,165,551,439082.363206255,4,0,1,1,5
Fiji,FJ,East Asia & Pacific,2020-05-23,cargo,0,0,0,0,0,0,0,0,1,1,1
Fiji,FJ,East Asia & Pacific,2020-05-23,passenger,152,0,0,0,152,24352.47800689665,3,0,0,0,3
Fiji,FJ,East Asia & Pacific,2020-05-24,cargo,0,0,0,0,0,0,0,1,0,1,1
Fiji,FJ,East Asia & Pacific,2020-05-24,passenger,130,0,294,294,424,2107749.270174189,2,0,1,1,3
Fiji,FJ,East Asia & Pacific,2020-05-25,cargo,0,0,0,0,0,0,0,0,1,1,1
Fiji,FJ,East Asia & Pacific,2020-05-25,passenger,130,0,0,0,130,15921.826172842602,2,0,0,0,2
Fiji,FJ,East Asia & Pacific,2020-05-26,cargo,0,0,0,0,0,0,0,0,1,1,1
Fiji,FJ,East Asia & Pacific,2020-05-26,passenger,204,0,0,0,204,24985.01953276839,2,0,0,0,2
Fiji,FJ,East Asia & Pacific,2020-05-27,cargo,0,0,0,0,0,0,0,1,1,2,2
Fiji,FJ,East Asia & Pacific,2020-05-27,passenger,247,0,136,136,383,312585.26358407474,3,0,1,1,4
Fiji,FJ,East Asia & Pacific,2020-05-28,cargo,0,0,0,0,0,0,0,1,1,2,2
Fiji,FJ,East Asia & Pacific,2020-05-28,passenger,298,0,0,0,298,73673.10056818253,4,0,0,0,4
Fiji,FJ,East Asia & Pacific,2020-05-29,cargo,0,0,0,0,0,0,0,0,1,1,1
Fiji,FJ,East Asia & Pacific,2020-05-29,passenger,342,0,165,165,507,433693.43742467754,4,0,1,1,5
Fiji,FJ,East Asia & Pacific,2020-05-30,cargo,0,0,0,0,0,0,0,0,1,1,1
Fiji,FJ,East Asia & Pacific,2020-05-30,passenger,230,0,0,0,230,33905.573710602206,3,0,0,0,3
Fiji,FJ,East Asia & Pacific,2020-05-31,cargo,0,0,0,0,0,0,0,1,0,1,1
Fiji,FJ,East Asia & Pacific,2020-05-31,passenger,184,0,0,0,184,22535.507813869528,2,0,0,0,2
Fiji,FJ,East Asia & Pacific,2020-06-01,cargo,0,0,0,0,0,0,0,0,1,1,1
Fiji,FJ,East Asia & Pacific,2020-06-01,passenger,111,0,0,0,111,13594.790039888683,2,0,0,0,2
Fiji,FJ,East Asia & Pacific,2020-06-02,cargo,0,0,0,0,0,0,0,0,1,1,1
Fiji,FJ,East Asia & Pacific,2020-06-02,passenger,130,0,0,0,130,11267.753906934764,3,0,0,0,3
Fiji,FJ,East Asia & Pacific,2020-06-03,cargo,0,0,0,0,0,0,0,0,1,1,1
Fiji,FJ,East Asia & Pacific,2020-06-03,passenger,171,0,0,0,171,18616.28906363135,3,0,0,0,3
Fiji,FJ,East Asia & Pacific,2020-06-04,cargo,0,0,0,0,0,0,0,1,0,1,1
Fiji,FJ,East Asia & Pacific,2020-06-04,passenger,342,0,0,0,342,110501.21336308421,5,0,0,0,5
Fiji,FJ,East Asia & Pacific,2020-06-05,cargo,0,0,0,0,0,0,0,0,1,1,1
Fiji,FJ,East Asia & Pacific,2020-06-05,passenger,184,0,165,165,349,377166.91888878704,2,0,1,1,3
Fiji,FJ,East Asia & Pacific,2020-06-06,cargo,0,0,0,0,0,0,0,0,1,1,1
Fiji,FJ,East Asia & Pacific,2020-06-06,passenger,249,0,0,0,249,33905.573710602206,4,0,0,0,4
Fiji,FJ,East Asia & Pacific,2020-06-07,cargo,0,0,0,0,0,0,0,1,0,1,1
Fiji,FJ,East Asia & Pacific,2020-06-07,passenger,157,0,291,291,448,2096900.8677868377,3,0,1,1,4
Fiji,FJ,East Asia & Pacific,2020-06-08,cargo,0,0,0,0,0,0,0,0,1,1,1
Fiji,FJ,East Asia & Pacific,2020-06-08,passenger,138,0,0,0,138,22637.819803667444,3,0,0,0,3
Fiji,FJ,East Asia & Pacific,2020-06-09,cargo,0,0,0,0,0,0,0,0,1,1,1
Fiji,FJ,East Asia & Pacific,2020-06-09,passenger,111,0,0,0,111,13594.790039888683,2,0,0,0,2
Fiji,FJ,East Asia & Pacific,2020-06-10,cargo,0,0,0,0,0,0,0,0,1,1,1
Fiji,FJ,East Asia & Pacific,2020-06-10,passenger,111,0,0,0,111,13594.790039888683,2,0,0,0,2
Fiji,FJ,East Asia & Pacific,2020-06-11,cargo,0,0,0,0,0,0,0,1,0,1,1
Fiji,FJ,East Asia & Pacific,2020-06-11,passenger,217,0,0,0,217,53860.190949769174,5,0,0,0,5
Fiji,FJ,East Asia & Pacific,2020-06-12,cargo,0,0,0,0,0,0,0,0,1,1,1
Fiji,FJ,East Asia & Pacific,2020-06-12,passenger,206,0,275,275,481,659193.8873960424,5,0,1,1,6
Fiji,FJ,East Asia & Pacific,2020-06-13,cargo,0,0,0,0,0,0,0,0,1,1,1
Fiji,FJ,East Asia & Pacific,2020-06-13,passenger,130,0,68,68,198,79887.31923616404,3,0,1,1,4
Fiji,FJ,East Asia & Pacific,2020-06-14,cargo,0,0,0,0,0,0,0,1,0,1,1
Fiji,FJ,East Asia & Pacific,2020-06-14,passenger,157,0,0,0,157,24964.855936621363,3,0,0,0,3
Fiji,FJ,East Asia & Pacific,2020-06-15,cargo,0,0,0,0,0,0,0,0,1,1,1
Fiji,FJ,East Asia & Pacific,2020-06-15,passenger,138,0,0,0,138,28374.008746932745,3,0,0,0,3
Fiji,FJ,East Asia & Pacific,2020-06-16,cargo,0,0,0,0,0,0,0,0,1,1,1
Fiji,FJ,East Asia & Pacific,2020-06-16,passenger,65,0,0,0,65,7960.9130864213,2,0,0,0,2
Fiji,FJ,East Asia & Pacific,2020-06-17,cargo,0,0,0,0,0,0,0,1,1,2,2
Fiji,FJ,East Asia & Pacific,2020-06-17,passenger,65,0,0,0,65,7960.9130864213,2,0,0,0,2
Fiji,FJ,East Asia & Pacific,2020-06-18,cargo,0,0,0,0,0,0,0,1,1,2,2
Fiji,FJ,East Asia & Pacific,2020-06-18,passenger,179,0,68,68,247,135675.74464422476,3,0,1,1,4
Fiji,FJ,East Asia & Pacific,2020-06-19,cargo,0,0,0,0,0,0,0,0,1,1,1
Fiji,FJ,East Asia & Pacific,2020-06-19,passenger,252,0,165,165,417,428406.823632898,5,0,1,1,6
Fiji,FJ,East Asia & Pacific,2020-06-20,cargo,0,0,0,0,0,0,0,0,1,1,1
Fiji,FJ,East Asia & Pacific,2020-06-20,passenger,203,0,0,0,203,33853.95576143659,4,0,0,0,4
Fiji,FJ,East Asia & Pacific,2020-06-21,cargo,0,0,0,0,0,0,0,1,0,1,1
Fiji,FJ,East Asia & Pacific,2020-06-21,passenger,203,0,165,165,368,388485.36683635414,4,0,1,1,5
Fiji,FJ,East Asia & Pacific,2020-06-22,cargo,0,0,0,0,0,0,0,0,1,1,1
Fiji,FJ,East Asia & Pacific,2020-06-22,passenger,203,0,0,0,203,36334.92183335405,4,0,0,0,4
Fiji,FJ,East Asia & Pacific,2020-06-23,cargo,0,0,0,0,0,0,0,0,1,1,1
Fiji,FJ,East Asia & Pacific,2020-06-23,passenger,152,0,0,0,152,18616.28906363135,2,0,0,0,2
Fiji,FJ,East Asia & Pacific,2020-06-24,cargo,0,0,0,0,0,0,0,0,1,1,1
Fiji,FJ,East Asia & Pacific,2020-06-24,passenger,133,0,0,0,133,16289.25293067743,2,0,0,0,2
Fiji,FJ,East Asia & Pacific,2020-06-25,cargo,0,0,0,0,0,0,0,1,1,2,2
Fiji,FJ,East Asia & Pacific,2020-06-25,passenger,179,0,0,0,179,53362.31689746901,3,0,0,0,3
Fiji,FJ,East Asia & Pacific,2020-06-26,cargo,0,0,0,0,0,0,0,0,1,1,1
Fiji,FJ,East Asia & Pacific,2020-06-26,passenger,271,0,165,165,436,430733.8597658519,5,0,1,1,6
Fiji,FJ,East Asia & Pacific,2020-06-27,cargo,0,0,0,0,0,0,0,0,1,1,1
Fiji,FJ,East Asia & Pacific,2020-06-27,passenger,111,0,0,0,111,13594.790039888683,2,0,0,0,2
Fiji,FJ,East Asia & Pacific,2020-06-28,cargo,0,0,0,0,0,0,0,1,0,1,1
Fiji,FJ,East Asia & Pacific,2020-06-28,passenger,203,0,164,164,367,481239.6900216044,4,0,1,1,5
Fiji,FJ,East Asia & Pacific,2020-06-29,cargo,0,0,0,0,0,0,0,0,1,1,1
Fiji,FJ,East Asia & Pacific,2020-06-29,passenger,157,0,0,0,157,22637.819803667444,4,0,0,0,4
Fiji,FJ,East Asia & Pacific,2020-06-30,cargo,0,0,0,0,0,0,0,0,2,2,2
Fiji,FJ,East Asia & Pacific,2020-06-30,passenger,46,0,0,0,46,8889.099824815228,1,0,0,0,1
Fiji,FJ,East Asia & Pacific,2020-07-01,cargo,0,0,0,0,0,0,0,1,0,1,1
Fiji,FJ,East Asia & Pacific,2020-07-01,passenger,152,0,0,0,152,18616.28906363135,2,0,0,0,2
Fiji,FJ,East Asia & Pacific,2020-07-02,passenger,220,0,275,275,495,647109.131579787,4,0,1,1,5
Fiji,FJ,East Asia & Pacific,2020-07-03,cargo,0,0,0,0,0,0,0,1,1,2,2
Fiji,FJ,East Asia & Pacific,2020-07-03,passenger,203,0,0,0,203,36334.92183335405,4,0,0,0,4
Fiji,FJ,East Asia & Pacific,2020-07-04,cargo,0,0,0,0,0,0,0,0,1,1,1
Fiji,FJ,East Asia & Pacific,2020-07-04,passenger,133,0,0,0,133,16289.25293067743,2,0,0,0,2
Fiji,FJ,East Asia & Pacific,2020-07-05,cargo,0,0,0,0,0,0,0,1,0,1,1
Fiji,FJ,East Asia & Pacific,2020-07-05,passenger,288,0,68,68,356,281116.9154310658,4,0,1,1,5
Fiji,FJ,East Asia & Pacific,2020-07-06,cargo,0,0,0,0,0,0,0,0,1,1,1
Fiji,FJ,East Asia & Pacific,2020-07-06,passenger,92,0,0,0,92,22740.131793465363,3,0,0,0,3
Fiji,FJ,East Asia & Pacific,2020-07-07,cargo,0,0,0,0,0,0,0,0,1,1,1
Fiji,FJ,East Asia & Pacific,2020-07-08,cargo,0,0,0,0,0,0,0,1,0,1,1
Fiji,FJ,East Asia & Pacific,2020-07-08,passenger,0,0,302,302,302,649082.9463310612,0,0,1,1,1
Fiji,FJ,East Asia & Pacific,2020-07-10,cargo,0,0,0,0,0,0,0,0,1,1,1
Fiji,FJ,East Asia & Pacific,2020-07-11,cargo,0,0,0,0,0,0,0,1,1,2,2
Fiji,FJ,East Asia & Pacific,2020-07-13,cargo,0,0,0,0,0,0,0,0,1,1,1
Fiji,FJ,East Asia & Pacific,2020-07-13,passenger,0,0,68,68,68,59012.44335631816,0,0,1,1,1
Fiji,FJ,East Asia & Pacific,2020-07-14,cargo,0,0,0,0,0,0,0,0,2,2,2
Fiji,FJ,East Asia & Pacific,2020-07-15,cargo,0,0,0,0,0,0,0,1,0,1,1
Fiji,FJ,East Asia & Pacific,2020-07-15,passenger,19,0,275,275,294,594101.3175104194,1,0,1,1,2
Fiji,FJ,East Asia & Pacific,2020-07-17,cargo,0,0,0,0,0,0,0,0,1,1,1
Fiji,FJ,East Asia & Pacific,2020-07-18,cargo,0,0,0,0,0,0,0,0,1,1,1
Fiji,FJ,East Asia & Pacific,2020-07-19,cargo,0,0,0,0,0,0,0,1,0,1,1
Fiji,FJ,East Asia & Pacific,2020-07-19,passenger,310,0,0,0,310,35640.395509978436,3,0,0,0,3
Fiji,FJ,East Asia & Pacific,2020-07-20,cargo,0,0,0,0,0,0,0,0,1,1,1
Fiji,FJ,East Asia & Pacific,2020-07-20,passenger,272,0,0,0,272,33313.35937702452,2,0,0,0,2
Fiji,FJ,East Asia & Pacific,2020-07-21,cargo,0,0,0,0,0,0,0,0,1,1,1
Fiji,FJ,East Asia & Pacific,2020-07-21,passenger,136,0,68,68,204,82451.33483248745,2,0,1,1,3
Fiji,FJ,East Asia & Pacific,2020-07-22,cargo,0,0,0,0,0,0,0,0,1,1,1
Fiji,FJ,East Asia & Pacific,2020-07-22,passenger,174,0,214,214,388,210551.39855524956,2,0,2,2,4
Fiji,FJ,East Asia & Pacific,2020-07-23,cargo,0,0,0,0,0,0,0,1,0,1,1
Fiji,FJ,East Asia & Pacific,2020-07-23,passenger,223,0,302,302,525,707834.1890101077,3,0,1,1,4
Fiji,FJ,East Asia & Pacific,2020-07-24,cargo,0,0,0,0,0,0,0,0,1,1,1
Fiji,FJ,East Asia & Pacific,2020-07-24,passenger,272,0,0,0,272,64752.54639034872,3,0,0,0,3
Fiji,FJ,East Asia & Pacific,2020-07-25,cargo,0,0,0,0,0,0,0,0,1,1,1
Fiji,FJ,East Asia & Pacific,2020-07-25,passenger,136,0,0,0,136,16656.67968851226,2,0,0,0,2
Fiji,FJ,East Asia & Pacific,2020-07-26,cargo,0,0,0,0,0,0,0,1,0,1,1
Fiji,FJ,East Asia & Pacific,2020-07-26,passenger,155,0,0,0,155,18983.71582146618,2,0,0,0,2
Fiji,FJ,East Asia & Pacific,2020-07-27,cargo,0,0,0,0,0,0,0,0,1,1,1
Fiji,FJ,East Asia & Pacific,2020-07-27,passenger,38,0,0,0,38,4654.072265907837,2,0,0,0,2
Fiji,FJ,East Asia & Pacific,2020-07-28,cargo,0,0,0,0,0,0,0,0,1,1,1
Fiji,FJ,East Asia & Pacific,2020-07-28,passenger,174,0,68,68,242,87105.40709839528,2,0,1,1,3
Fiji,FJ,East Asia & Pacific,2020-07-29,cargo,0,0,0,0,0,0,0,1,1,2,2
Fiji,FJ,East Asia & Pacific,2020-07-29,passenger,155,0,0,0,155,18983.71582146618,2,0,0,0,2
Fiji,FJ,East Asia & Pacific,2020-07-30,cargo,0,0,0,0,0,0,0,1,0,1,1
Fiji,FJ,East Asia & Pacific,2020-07-30,passenger,359,0,275,275,634,664133.238026134,4,0,1,1,5
Fiji,FJ,East Asia & Pacific,2020-07-31,cargo,0,0,0,0,0,0,0,0,1,1,1
Fiji,FJ,East Asia & Pacific,2020-07-31,passenger,272,0,0,0,272,64752.54639034872,3,0,0,0,3
Fiji,FJ,East Asia & Pacific,2020-08-01,cargo,0,0,0,0,0,0,0,0,1,1,1
Fiji,FJ,East Asia & Pacific,2020-08-01,passenger,272,0,0,0,272,33313.35937702452,2,0,0,0,2
Fiji,FJ,East Asia & Pacific,2020-08-02,cargo,0,0,0,0,0,0,0,1,0,1,1
Fiji,FJ,East Asia & Pacific,2020-08-02,passenger,272,0,0,0,272,33313.35937702452,2,0,0,0,2
Fiji,FJ,East Asia & Pacific,2020-08-03,cargo,0,0,0,0,0,0,0,0,1,1,1
Fiji,FJ,East Asia & Pacific,2020-08-03,passenger,136,0,0,0,136,16656.67968851226,2,0,0,0,2
Fiji,FJ,East Asia & Pacific,2020-08-04,cargo,0,0,0,0,0,0,0,0,1,1,1
Fiji,FJ,East Asia & Pacific,2020-08-04,passenger,511,0,68,68,579,97270.88073182557,2,0,1,1,3
Fiji,FJ,East Asia & Pacific,2020-08-05,cargo,0,0,0,0,0,0,0,0,1,1,1
Fiji,FJ,East Asia & Pacific,2020-08-05,passenger,242,0,0,0,242,27312.05566572231,3,0,0,0,3
Fiji,FJ,East Asia & Pacific,2020-08-06,cargo,0,0,0,0,0,0,0,1,0,1,1
Fiji,FJ,East Asia & Pacific,2020-08-06,passenger,681,0,472,472,1153,1309490.6762363072,4,0,2,2,6
Fiji,FJ,East Asia & Pacific,2020-08-07,cargo,0,0,0,0,0,0,0,0,1,1,1
Fiji,FJ,East Asia & Pacific,2020-08-07,passenger,340,0,0,0,340,73080.88623460484,3,0,0,0,3
Fiji,FJ,East Asia & Pacific,2020-08-08,cargo,0,0,0,0,0,0,0,0,1,1,1
Fiji,FJ,East Asia & Pacific,2020-08-08,passenger,204,0,68,68,272,107298.44727952416,2,0,1,1,3
Fiji,FJ,East Asia & Pacific,2020-08-09,cargo,0,0,0,0,0,0,0,1,0,1,1
Fiji,FJ,East Asia & Pacific,2020-08-09,passenger,291,0,0,0,291,38009.69094306628,3,0,0,0,3
Fiji,FJ,East Asia & Pacific,2020-08-10,cargo,0,0,0,0,0,0,0,0,1,1,1
Fiji,FJ,East Asia & Pacific,2020-08-10,passenger,155,0,0,0,155,18983.71582146618,2,0,0,0,2
Fiji,FJ,East Asia & Pacific,2020-08-11,cargo,0,0,0,0,0,0,0,0,1,1,1
Fiji,FJ,East Asia & Pacific,2020-08-11,passenger,447,0,68,68,515,87105.40709839528,3,0,1,1,4
Fiji,FJ,East Asia & Pacific,2020-08-12,cargo,0,0,0,0,0,0,1,0,1,1,2
Fiji,FJ,East Asia & Pacific,2020-08-12,passenger,193,0,299,299,492,2508844.1238899333,2,0,1,1,3
Fiji,FJ,East Asia & Pacific,2020-08-13,cargo,0,0,0,0,0,0,0,1,1,2,2
Fiji,FJ,East Asia & Pacific,2020-08-13,passenger,291,0,302,302,593,716162.5288543637,3,0,1,1,4
Fiji,FJ,East Asia & Pacific,2020-08-14,cargo,0,0,0,0,0,0,0,0,2,2,2
Fiji,FJ,East Asia & Pacific,2020-08-14,passenger,340,0,0,0,340,73080.88623460484,3,0,0,0,3
Fiji,FJ,East Asia & Pacific,2020-08-15,cargo,0,0,0,0,0,0,0,0,1,1,1
Fiji,FJ,East Asia & Pacific,2020-08-15,passenger,272,0,0,0,272,33313.35937702452,2,0,0,0,2
Fiji,FJ,East Asia & Pacific,2020-08-16,cargo,0,0,0,0,0,0,0,0,1,1,1
Fiji,FJ,East Asia & Pacific,2020-08-16,passenger,272,0,0,0,272,33313.35937702452,2,0,0,0,2
Fiji,FJ,East Asia & Pacific,2020-08-17,cargo,0,0,0,0,0,0,0,1,0,1,1
Fiji,FJ,East Asia & Pacific,2020-08-17,passenger,555,0,0,0,555,31638.066202261703,4,0,0,0,4
Fiji,FJ,East Asia & Pacific,2020-08-18,cargo,0,0,0,0,0,0,0,0,3,3,3
Fiji,FJ,East Asia & Pacific,2020-08-18,passenger,155,0,214,214,369,269685.1554241108,2,0,2,2,4
Fiji,FJ,East Asia & Pacific,2020-08-19,cargo,0,0,0,0,0,0,0,0,1,1,1
Fiji,FJ,East Asia & Pacific,2020-08-19,passenger,204,0,0,0,204,24985.01953276839,2,0,0,0,2
Fiji,FJ,East Asia & Pacific,2020-08-20,cargo,0,0,0,0,0,0,0,1,2,3,3
Fiji,FJ,East Asia & Pacific,2020-08-20,passenger,340,0,275,275,615,664133.238026134,4,0,1,1,5
Fiji,FJ,East Asia & Pacific,2020-08-21,cargo,0,0,0,0,0,0,0,0,2,2,2
Fiji,FJ,East Asia & Pacific,2020-08-21,passenger,359,0,313,313,672,1065232.8312998887,4,0,1,1,5
Fiji,FJ,East Asia & Pacific,2020-08-22,passenger,204,0,214,214,418,484931.21329054027,2,0,1,1,3
Fiji,FJ,East Asia & Pacific,2020-08-23,passenger,204,0,0,0,204,24985.01953276839,2,0,0,0,2
Fiji,FJ,East Asia & Pacific,2020-08-24,cargo,0,0,0,0,0,0,0,1,0,1,1
Fiji,FJ,East Asia & Pacific,2020-08-24,passenger,174,0,0,0,174,21310.7519544201,2,0,0,0,2
Fiji,FJ,East Asia & Pacific,2020-08-25,cargo,0,0,0,0,0,0,0,0,2,2,2
Fiji,FJ,East Asia & Pacific,2020-08-25,passenger,174,0,381,381,555,759830.4475011175,2,0,2,2,4
Fiji,FJ,East Asia & Pacific,2020-08-26,cargo,0,0,0,0,0,0,0,0,1,1,1
Fiji,FJ,East Asia & Pacific,2020-08-26,passenger,318,0,0,0,318,33313.35937702452,3,0,0,0,3
Fiji,FJ,East Asia & Pacific,2020-08-27,cargo,0,0,0,0,0,0,0,1,1,2,2
Fiji,FJ,East Asia & Pacific,2020-08-27,passenger,432,0,516,516,948,1209874.9457584135,5,0,1,1,6
Fiji,FJ,East Asia & Pacific,2020-08-28,cargo,0,0,0,0,0,0,0,0,2,2,2
Fiji,FJ,East Asia & Pacific,2020-08-28,passenger,155,0,0,0,155,18983.71582146618,2,0,0,0,2
Fiji,FJ,East Asia & Pacific,2020-08-29,passenger,228,0,0,0,228,12982.412110163968,3,0,0,0,3
Fiji,FJ,East Asia & Pacific,2020-08-30,passenger,296,0,0,0,296,21310.7519544201,3,0,0,0,3
Fiji,FJ,East Asia & Pacific,2020-08-31,cargo,0,0,0,0,0,0,0,1,0,1,1
Fiji,FJ,East Asia & Pacific,2020-08-31,passenger,293,0,0,0,293,20943.32519658527,3,0,0,0,3
Fiji,FJ,East Asia & Pacific,2020-09-01,cargo,0,0,0,0,0,0,0,0,2,2,2
Fiji,FJ,East Asia & Pacific,2020-09-01,passenger,157,0,68,68,225,85023.32213733127,2,0,1,1,3
Fiji,FJ,East Asia & Pacific,2020-09-02,cargo,0,0,0,0,0,0,0,1,0,1,1
Fiji,FJ,East Asia & Pacific,2020-09-02,passenger,198,0,571,571,769,2900213.1201189896,3,0,3,3,6
Fiji,FJ,East Asia & Pacific,2020-09-03,cargo,0,0,0,0,0,0,0,1,1,2,2
Fiji,FJ,East Asia & Pacific,2020-09-03,passenger,163,0,275,275,438,609895.0357122662,3,0,1,1,4
Fiji,FJ,East Asia & Pacific,2020-09-04,cargo,0,0,0,0,0,0,0,0,2,2,2
Fiji,FJ,East Asia & Pacific,2020-09-04,passenger,418,0,313,313,731,1059843.905518311,4,0,1,1,5
Fiji,FJ,East Asia & Pacific,2020-09-05,passenger,315,0,0,0,315,72017.97098956675,4,0,0,0,4
Fiji,FJ,East Asia & Pacific,2020-09-06,passenger,242,0,0,0,242,33172.32747629532,3,0,0,0,3
Fiji,FJ,East Asia & Pacific,2020-09-07,cargo,0,0,0,0,0,0,0,1,0,1,1
Fiji,FJ,East Asia & Pacific,2020-09-07,passenger,291,0,0,0,291,38009.69094306628,3,0,0,0,3
Fiji,FJ,East Asia & Pacific,2020-09-08,cargo,0,0,0,0,0,0,0,0,2,2,2
Fiji,FJ,East Asia & Pacific,2020-09-08,passenger,201,0,654,654,855,3005637.669728932,2,0,3,3,5
Fiji,FJ,East Asia & Pacific,2020-09-09,passenger,190,0,273,273,463,2265813.0020369743,4,0,1,1,5
Fiji,FJ,East Asia & Pacific,2020-09-10,cargo,0,0,0,0,0,0,0,1,0,1,1
Fiji,FJ,East Asia & Pacific,2020-09-10,passenger,152,0,615,615,767,1340424.2757974148,2,0,1,1,3
Fiji,FJ,East Asia & Pacific,2020-09-11,cargo,0,0,0,0,0,0,0,0,1,1,1
Fiji,FJ,East Asia & Pacific,2020-09-11,passenger,179,0,313,313,492,726087.3573001913,3,0,1,1,4
Fiji,FJ,East Asia & Pacific,2020-09-12,passenger,198,0,0,0,198,55689.35303042293,3,0,0,0,3
Fiji,FJ,East Asia & Pacific,2020-09-13,passenger,244,0,0,0,244,41356.42085709672,4,0,0,0,4
Fiji,FJ,East Asia & Pacific,2020-09-14,cargo,0,0,0,0,0,0,0,1,0,1,1
Fiji,FJ,East Asia & Pacific,2020-09-14,passenger,266,0,0,0,266,44313.312387964455,4,0,0,0,4
Fiji,FJ,East Asia & Pacific,2020-09-15,cargo,0,0,0,0,0,0,0,0,1,1,1
Fiji,FJ,East Asia & Pacific,2020-09-15,passenger,198,0,381,381,579,762769.8615637962,2,0,2,2,4
Fiji,FJ,East Asia & Pacific,2020-09-16,cargo,0,0,0,0,0,0,0,0,1,1,1
Fiji,FJ,East Asia & Pacific,2020-09-16,passenger,239,0,449,449,688,2810977.706291407,3,0,3,3,6
Fiji,FJ,East Asia & Pacific,2020-09-17,cargo,0,0,0,0,0,0,0,1,0,1,1
Fiji,FJ,East Asia & Pacific,2020-09-17,passenger,106,0,656,656,762,1347390.6008310376,2,0,2,2,4
Fiji,FJ,East Asia & Pacific,2020-09-18,cargo,0,0,0,0,0,0,0,0,1,1,1
Fiji,FJ,East Asia & Pacific,2020-09-18,passenger,408,0,313,313,721,771093.4337921067,6,0,1,1,7
Fiji,FJ,East Asia & Pacific,2020-09-19,passenger,359,0,0,0,359,75407.92236755877,3,0,0,0,3
Fiji,FJ,East Asia & Pacific,2020-09-20,passenger,364,0,0,0,364,61540.280594482785,5,0,0,0,5
Fiji,FJ,East Asia & Pacific,2020-09-21,cargo,0,0,0,0,0,0,0,1,0,1,1
Fiji,FJ,East Asia & Pacific,2020-09-21,passenger,364,0,0,0,364,61540.280594482785,4,0,0,0,4
Fiji,FJ,East Asia & Pacific,2020-09-22,cargo,0,0,0,0,0,0,0,0,1,1,1
Fiji,FJ,East Asia & Pacific,2020-09-22,passenger,269,0,381,381,650,771465.6281658871,2,0,2,2,4
Fiji,FJ,East Asia & Pacific,2020-09-23,passenger,242,0,313,313,555,2596056.885395352,3,0,1,1,4
Fiji,FJ,East Asia & Pacific,2020-09-24,cargo,0,0,0,0,0,0,0,1,0,1,1
Fiji,FJ,East Asia & Pacific,2020-09-24,passenger,228,0,785,785,1013,1514219.0581891683,2,0,2,2,4
Fiji,FJ,East Asia & Pacific,2020-09-25,cargo,0,0,0,0,0,0,0,0,1,1,1
Fiji,FJ,East Asia & Pacific,2020-09-25,passenger,432,0,381,381,813,921488.4229055651,5,0,2,2,7
Fiji,FJ,East Asia & Pacific,2020-09-26,passenger,359,0,0,0,359,73080.88623460484,4,0,0,0,4
Fiji,FJ,East Asia & Pacific,2020-09-27,cargo,0,0,0,0,0,0,0,1,0,1,1
Fiji,FJ,East Asia & Pacific,2020-09-27,passenger,383,0,0,0,383,60199.8016646022,4,0,0,0,4
Fiji,FJ,East Asia & Pacific,2020-09-28,cargo,0,0,0,0,0,0,0,1,0,1,1
Fiji,FJ,East Asia & Pacific,2020-09-28,passenger,136,0,0,0,136,33615.846999035755,2,0,0,0,2
Fiji,FJ,East Asia & Pacific,2020-09-29,passenger,228,0,146,146,374,219341.66379681212,3,0,1,1,4
Fiji,FJ,East Asia & Pacific,2020-09-30,passenger,225,0,527,527,752,2862078.2430184097,3,0,3,3,6
Fiji,FJ,East Asia & Pacific,2020-10-01,cargo,0,0,0,0,0,0,0,1,0,1,1
Fiji,FJ,East Asia & Pacific,2020-10-01,passenger,272,273,656,929,1201,3792326.9910013825,2,1,2,3,5
Fiji,FJ,East Asia & Pacific,2020-10-02,cargo,0,0,0,0,0,0,0,0,1,1,1
Fiji,FJ,East Asia & Pacific,2020-10-02,passenger,476,0,459,459,935,902867.765093217,5,0,2,2,7
Fiji,FJ,East Asia & Pacific,2020-10-03,passenger,340,0,0,0,340,73080.88623460484,3,0,0,0,3
Fiji,FJ,East Asia & Pacific,2020-10-04,passenger,446,0,0,0,446,71583.27864196812,4,0,0,0,4
Fiji,FJ,East Asia & Pacific,2020-10-05,cargo,0,0,0,0,0,0,0,1,0,1,1
Fiji,FJ,East Asia & Pacific,2020-10-05,passenger,383,0,0,0,383,65790.43936027259,5,0,0,0,5
Fiji,FJ,East Asia & Pacific,2020-10-06,cargo,0,0,0,0,0,0,0,0,1,1,1
Fiji,FJ,East Asia & Pacific,2020-10-06,passenger,228,0,381,381,609,766444.1291421446,2,0,2,2,4
Fiji,FJ,East Asia & Pacific,2020-10-07,passenger,293,0,1075,1075,1368,4125526.8438001513,3,0,5,5,8
Fiji,FJ,East Asia & Pacific,2020-10-08,cargo,0,0,0,0,0,0,1,1,0,1,2
Fiji,FJ,East Asia & Pacific,2020-10-08,passenger,269,0,654,654,923,3043076.170452699,3,0,3,3,6
Fiji,FJ,East Asia & Pacific,2020-10-09,cargo,0,0,0,0,0,0,0,0,1,1,1
Fiji,FJ,East Asia & Pacific,2020-10-09,passenger,476,0,313,313,789,779421.7736363627,5,0,1,1,6
Fiji,FJ,East Asia & Pacific,2020-10-10,passenger,359,0,273,273,632,312325.525842189,3,0,1,1,4
Fiji,FJ,East Asia & Pacific,2020-10-11,passenger,364,0,0,0,364,61540.280594482785,4,0,0,0,4
Fiji,FJ,East Asia & Pacific,2020-10-12,passenger,320,0,0,0,320,56151.35481290528,4,0,0,0,4
Fiji,FJ,East Asia & Pacific,2020-10-13,cargo,0,0,0,0,0,0,0,1,0,1,1
Fiji,FJ,East Asia & Pacific,2020-10-13,passenger,250,0,381,381,631,769138.5920329333,2,0,2,2,4
Fiji,FJ,East Asia & Pacific,2020-10-14,cargo,0,0,0,0,0,0,0,1,1,2,2
Fiji,FJ,East Asia & Pacific,2020-10-14,passenger,206,0,313,313,519,2596301.8365672417,2,0,1,1,3
Fiji,FJ,East Asia & Pacific,2020-10-15,cargo,0,0,0,0,0,0,0,1,0,1,1
Fiji,FJ,East Asia & Pacific,2020-10-15,passenger,228,0,313,313,541,700649.4739981694,2,0,1,1,3
Fiji,FJ,East Asia & Pacific,2020-10-16,cargo,0,0,0,0,0,0,0,0,1,1,1
Fiji,FJ,East Asia & Pacific,2020-10-16,passenger,476,0,313,313,789,779421.7736363627,5,0,1,1,6
Fiji,FJ,East Asia & Pacific,2020-10-17,passenger,315,0,294,294,609,679455.1490795035,3,0,2,2,5
Fiji,FJ,East Asia & Pacific,2020-10-18,passenger,250,0,0,0,250,47578.06379675926,4,0,0,0,4
Fiji,FJ,East Asia & Pacific,2020-10-19,cargo,0,0,0,0,0,0,0,1,0,1,1
Fiji,FJ,East Asia & Pacific,2020-10-19,passenger,320,0,335,335,655,575269.4037477608,4,0,2,2,6
Fiji,FJ,East Asia & Pacific,2020-10-20,cargo,0,0,0,0,0,0,0,0,1,1,1
Fiji,FJ,East Asia & Pacific,2020-10-20,passenger,250,0,551,551,801,933625.2298928713,2,0,2,2,4
Fiji,FJ,East Asia & Pacific,2020-10-21,passenger,206,0,381,381,587,2662096.491711217,2,0,2,2,4
Fiji,FJ,East Asia & Pacific,2020-10-22,cargo,0,0,0,0,0,0,0,1,0,1,1
Fiji,FJ,East Asia & Pacific,2020-10-22,passenger,228,0,586,586,814,3216248.7348893657,2,0,2,2,4
Fiji,FJ,East Asia & Pacific,2020-10-23,cargo,0,0,0,0,0,0,0,0,2,2,2
Fiji,FJ,East Asia & Pacific,2020-10-23,passenger,476,0,302,302,778,755779.6795647016,5,0,1,1,6
Fiji,FJ,East Asia & Pacific,2020-10-24,passenger,359,0,459,459,818,871578.9542271353,3,0,2,2,5
Fiji,FJ,East Asia & Pacific,2020-10-25,passenger,364,0,0,0,364,61540.280594482785,4,0,0,0,4
Fiji,FJ,East Asia & Pacific,2020-10-26,cargo,0,0,0,0,0,0,0,1,0,1,1
Fiji,FJ,East Asia & Pacific,2020-10-26,passenger,320,0,0,0,320,56151.35481290528,4,0,0,0,4
Fiji,FJ,East Asia & Pacific,2020-10-27,passenger,250,0,654,654,904,1634497.9562592031,2,0,3,3,5
Fiji,FJ,East Asia & Pacific,2020-10-28,cargo,0,0,0,0,0,0,0,0,1,1,1
Fiji,FJ,East Asia & Pacific,2020-10-28,passenger,206,0,381,381,587,2662096.491711217,2,0,2,2,4
Fiji,FJ,East Asia & Pacific,2020-10-29,cargo,0,0,0,0,0,0,0,1,0,1,1
Fiji,FJ,East Asia & Pacific,2020-10-29,passenger,228,0,588,588,816,1291701.8257896984,2,0,1,1,3
Fiji,FJ,East Asia & Pacific,2020-10-30,cargo,0,0,0,0,0,0,0,0,1,1,1
Fiji,FJ,East Asia & Pacific,2020-10-30,passenger,476,0,453,453,929,1254327.6882074238,5,0,2,2,7
Fiji,FJ,East Asia & Pacific,2020-10-31,passenger,378,0,273,273,651,943094.3227267825,3,0,1,1,4
Fiji,FJ,East Asia & Pacific,2020-11-01,cargo,0,0,0,0,0,0,0,1,0,1,1
Fiji,FJ,East Asia & Pacific,2020-11-01,passenger,364,0,0,0,364,61540.280594482785,4,0,0,0,4
Fiji,FJ,East Asia & Pacific,2020-11-02,cargo,0,0,0,0,0,0,0,0,1,1,1
Fiji,FJ,East Asia & Pacific,2020-11-02,passenger,320,0,0,0,320,50664.56538891239,4,0,0,0,4
Fiji,FJ,East Asia & Pacific,2020-11-03,cargo,0,0,0,0,0,0,0,0,1,1,1
Fiji,FJ,East Asia & Pacific,2020-11-03,passenger,250,0,68,68,318,96413.55163021096,2,0,1,1,3
Fiji,FJ,East Asia & Pacific,2020-11-04,cargo,0,0,0,0,0,0,0,0,1,1,1
Fiji,FJ,East Asia & Pacific,2020-11-04,passenger,206,0,586,586,792,3461661.2007935117,2,0,2,2,4
Fiji,FJ,East Asia & Pacific,2020-11-05,passenger,222,0,888,888,1110,3859942.75543885,3,0,2,2,5
Fiji,FJ,East Asia & Pacific,2020-11-06,cargo,0,0,0,0,0,0,0,1,0,1,1
Fiji,FJ,East Asia & Pacific,2020-11-06,passenger,451,0,313,313,764,774032.8478547854,6,0,1,1,7
Fiji,FJ,East Asia & Pacific,2020-11-07,passenger,359,0,313,313,672,1067559.8674328427,3,0,1,1,4
Fiji,FJ,East Asia & Pacific,2020-11-08,cargo,0,0,0,0,0,0,0,1,0,1,1
Fiji,FJ,East Asia & Pacific,2020-11-08,passenger,296,0,0,0,296,53211.940750226655,4,0,0,0,4
Fiji,FJ,East Asia & Pacific,2020-11-09,cargo,0,0,0,0,0,0,0,0,1,1,1
Fiji,FJ,East Asia & Pacific,2020-11-09,passenger,444,0,0,0,444,50517.477859437895,5,0,0,0,5
Fiji,FJ,East Asia & Pacific,2020-11-10,passenger,250,0,381,381,631,769138.5920329333,2,0,2,2,4
Fiji,FJ,East Asia & Pacific,2020-11-11,cargo,0,0,0,0,0,0,0,0,1,1,1
Fiji,FJ,East Asia & Pacific,2020-11-11,passenger,160,0,654,654,814,3521821.9789840197,2,0,3,3,5
Fiji,FJ,East Asia & Pacific,2020-11-12,passenger,228,0,826,826,1054,1895214.0126864668,2,0,3,3,5
Fiji,FJ,East Asia & Pacific,2020-11-13,cargo,0,0,0,0,0,0,0,1,0,1,1
Fiji,FJ,East Asia & Pacific,2020-11-13,passenger,476,0,586,586,1062,3264522.38832927,5,0,2,2,7
Fiji,FJ,East Asia & Pacific,2020-11-14,passenger,334,0,459,459,793,1249404.7622428886,3,0,2,2,5
Fiji,FJ,East Asia & Pacific,2020-11-15,cargo,0,0,0,0,0,0,0,1,0,1,1
Fiji,FJ,East Asia & Pacific,2020-11-15,passenger,203,0,0,0,203,22535.507813869528,3,0,0,0,3
Fiji,FJ,East Asia & Pacific,2020-11-16,cargo,0,0,0,0,0,0,0,0,1,1,1
Fiji,FJ,East Asia & Pacific,2020-11-16,passenger,320,0,0,0,320,53407.96010090884,4,0,0,0,4
Fiji,FJ,East Asia & Pacific,2020-11-17,passenger,250,0,381,381,631,769138.5920329333,2,0,2,2,4
Fiji,FJ,East Asia & Pacific,2020-11-18,cargo,0,0,0,0,0,0,0,0,1,1,1
Fiji,FJ,East Asia & Pacific,2020-11-18,passenger,433,0,273,273,706,898305.2968454596,3,0,1,1,4
Fiji,FJ,East Asia & Pacific,2020-11-19,cargo,0,0,0,0,0,0,0,0,1,1,1
Fiji,FJ,East Asia & Pacific,2020-11-19,passenger,272,0,1256,1256,1528,4561392.059024953,2,0,4,4,6
Fiji,FJ,East Asia & Pacific,2020-11-20,cargo,0,0,0,0,0,0,0,1,0,1,1
Fiji,FJ,East Asia & Pacific,2020-11-20,passenger,476,0,0,0,476,106696.73323364061,5,0,0,0,5
Fiji,FJ,East Asia & Pacific,2020-11-21,passenger,378,0,732,732,1110,1739265.354586359,3,0,3,3,6
Fiji,FJ,East Asia & Pacific,2020-11-22,cargo,0,0,0,0,0,0,0,1,0,1,1
Fiji,FJ,East Asia & Pacific,2020-11-22,passenger,320,0,164,164,484,501056.1230011557,4,0,1,1,5
Fiji,FJ,East Asia & Pacific,2020-11-23,cargo,0,0,0,0,0,0,0,0,1,1,1
Fiji,FJ,East Asia & Pacific,2020-11-23,passenger,252,0,0,0,252,39343.4313133874,3,0,0,0,3
Fiji,FJ,East Asia & Pacific,2020-11-24,passenger,386,0,313,313,699,736959.7838879938,4,0,1,1,5
Fiji,FJ,East Asia & Pacific,2020-11-25,cargo,0,0,0,0,0,0,0,0,1,1,1
Fiji,FJ,East Asia & Pacific,2020-11-25,passenger,269,0,779,779,1048,1830535.014994521,3,0,3,3,6
Fiji,FJ,East Asia & Pacific,2020-11-26,passenger,372,0,381,381,753,851308.2288367393,3,0,2,2,5
Fiji,FJ,East Asia & Pacific,2020-11-27,cargo,0,0,0,0,0,0,0,1,0,1,1
Fiji,FJ,East Asia & Pacific,2020-11-27,passenger,476,0,545,545,1021,3212147.7861232,5,0,3,3,8
Fiji,FJ,East Asia & Pacific,2020-11-28,cargo,0,0,0,0,0,0,0,1,1,2,2
Fiji,FJ,East Asia & Pacific,2020-11-28,passenger,359,0,313,313,672,748132.962770281,3,0,1,1,4
Fiji,FJ,East Asia & Pacific,2020-11-29,cargo,0,0,0,0,0,0,0,1,0,1,1
Fiji,FJ,East Asia & Pacific,2020-11-29,passenger,364,0,0,0,364,61540.280594482785,4,0,0,0,4
Fiji,FJ,East Asia & Pacific,2020-11-30,cargo,0,0,0,0,0,0,0,0,2,2,2
Fiji,FJ,East Asia & Pacific,2020-11-30,passenger,276,0,170,170,446,209762.27746727286,4,0,1,1,5
Fiji,FJ,East Asia & Pacific,2020-12-01,passenger,504,0,381,381,885,769138.5920329333,3,0,2,2,5
Fiji,FJ,East Asia & Pacific,2020-12-02,passenger,206,0,586,586,792,3461661.2007935117,2,0,2,2,4
Fiji,FJ,East Asia & Pacific,2020-12-03,passenger,482,0,739,739,1221,1708665.9373478037,3,0,2,2,5
Fiji,FJ,East Asia & Pacific,2020-12-04,cargo,0,0,0,0,0,0,0,1,0,1,1
Fiji,FJ,East Asia & Pacific,2020-12-04,passenger,454,0,0,0,454,104002.27034285186,5,0,0,0,5
Fiji,FJ,East Asia & Pacific,2020-12-05,cargo,0,0,0,0,0,0,0,0,1,1,1
Fiji,FJ,East Asia & Pacific,2020-12-05,passenger,269,0,483,483,752,1903083.3806681936,3,0,2,2,5
Fiji,FJ,East Asia & Pacific,2020-12-06,cargo,0,0,0,0,0,0,0,1,0,1,1
Fiji,FJ,East Asia & Pacific,2020-12-06,passenger,356,0,0,0,356,52080.89225166149,3,0,0,0,3
Fiji,FJ,East Asia & Pacific,2020-12-07,cargo,0,0,0,0,0,0,0,0,2,2,2
Fiji,FJ,East Asia & Pacific,2020-12-07,passenger,361,0,0,0,361,55686.06441265506,4,0,0,0,4
Fiji,FJ,East Asia & Pacific,2020-12-08,cargo,0,0,0,0,0,0,0,0,1,1,1
Fiji,FJ,East Asia & Pacific,2020-12-08,passenger,269,0,68,68,337,115259.36036594545,2,0,1,1,3
Fiji,FJ,East Asia & Pacific,2020-12-09,passenger,225,0,1168,1168,1393,4517806.5764664095,3,0,5,5,8
Fiji,FJ,East Asia & Pacific,2020-12-10,passenger,222,0,273,273,495,613615.3075834543,4,0,1,1,5
Fiji,FJ,East Asia & Pacific,2020-12-11,cargo,0,0,0,0,0,0,0,1,0,1,1
Fiji,FJ,East Asia & Pacific,2020-12-11,passenger,511,0,273,273,784,2345004.176493753,4,0,1,1,5
Fiji,FJ,East Asia & Pacific,2020-12-12,passenger,405,0,936,936,1341,2543272.785107709,4,0,3,3,7
Fiji,FJ,East Asia & Pacific,2020-12-13,cargo,0,0,0,0,0,0,0,1,0,1,1
Fiji,FJ,East Asia & Pacific,2020-12-13,passenger,454,0,623,623,1077,1207554.3432826432,4,0,3,3,7
Fiji,FJ,East Asia & Pacific,2020-12-14,cargo,0,0,0,0,0,0,0,0,1,1,1
Fiji,FJ,East Asia & Pacific,2020-12-14,passenger,252,0,487,487,739,817430.613817913,3,0,3,3,6
Fiji,FJ,East Asia & Pacific,2020-12-15,cargo,0,0,0,0,0,0,0,0,1,1,1
Fiji,FJ,East Asia & Pacific,2020-12-15,passenger,291,0,0,0,291,35640.395509978436,2,0,0,0,2
Fiji,FJ,East Asia & Pacific,2020-12-16,passenger,223,0,820,820,1043,1757189.3009905724,2,0,4,4,6
Fiji,FJ,East Asia & Pacific,2020-12-18,passenger,378,0,0,0,378,46295.77148718849,2,0,0,0,2
Fiji,FJ,East Asia & Pacific,2020-12-19,passenger,310,0,146,146,456,163412.39750337208,3,0,1,1,4
Fiji,FJ,East Asia & Pacific,2020-12-20,passenger,451,546,275,821,1272,5547431.316861132,6,1,1,2,8
Fiji,FJ,East Asia & Pacific,2020-12-21,cargo,0,0,0,0,0,0,0,0,2,2,2
Fiji,FJ,East Asia & Pacific,2020-12-21,passenger,271,0,1639,1639,1910,6196028.615431991,4,0,4,4,8
Fiji,FJ,East Asia & Pacific,2020-12-22,cargo,0,0,0,0,0,0,0,1,2,3,3
Fiji,FJ,East Asia & Pacific,2020-12-22,passenger,288,0,146,146,434,154064.88794309003,3,0,1,1,4
Fiji,FJ,East Asia & Pacific,2020-12-23,passenger,418,0,1331,1331,1749,5208144.656773911,6,0,4,4,10
Fiji,FJ,East Asia & Pacific,2020-12-24,passenger,383,0,273,273,656,637195.1743275777,3,0,1,1,4
Fiji,FJ,East Asia & Pacific,2020-12-25,passenger,291,313,0,313,604,2819032.6188388444,3,1,0,1,4
Fiji,FJ,East Asia & Pacific,2020-12-26,passenger,247,0,586,586,833,1568335.874357393,2,0,2,2,4
Fiji,FJ,East Asia & Pacific,2020-12-27,cargo,0,0,0,0,0,0,0,1,0,1,1
Fiji,FJ,East Asia & Pacific,2020-12-27,passenger,225,0,165,165,390,394201.23724541056,4,0,1,1,5
Fiji,FJ,East Asia & Pacific,2020-12-28,passenger,271,0,273,273,544,909028.8060761966,4,0,1,1,5
Fiji,FJ,East Asia & Pacific,2020-12-29,cargo,0,0,0,0,0,0,0,0,1,1,1
Fiji,FJ,East Asia & Pacific,2020-12-29,passenger,318,0,136,136,454,355047.2533324439,3,0,1,1,4
Fiji,FJ,East Asia & Pacific,2020-12-30,passenger,380,0,1167,1167,1547,4567088.491863783,6,0,5,5,11
Fiji,FJ,East Asia & Pacific,2020-12-31,cargo,0,0,0,0,0,0,0,0,1,1,1
Fiji,FJ,East Asia & Pacific,2020-12-31,passenger,296,0,0,0,296,36252.77343970315,2,0,0,0,2
Fiji,FJ,East Asia & Pacific,2021-01-01,passenger,315,0,68,68,383,121223.42543216013,4,0,1,1,5
Fiji,FJ,East Asia & Pacific,2021-01-02,passenger,315,0,273,273,588,912418.7574541887,3,0,1,1,4
Fiji,FJ,East Asia & Pacific,2021-01-03,cargo,0,0,0,0,0,0,0,1,0,1,1
Fiji,FJ,East Asia & Pacific,2021-01-03,passenger,407,0,0,0,407,124738.75683912107,6,0,0,0,6
Fiji,FJ,East Asia & Pacific,2021-01-04,cargo,0,0,0,0,0,0,1,0,1,1,2
Fiji,FJ,East Asia & Pacific,2021-01-04,passenger,315,0,273,273,588,635812.1568645497,4,0,1,1,5
Fiji,FJ,East Asia & Pacific,2021-01-05,cargo,0,0,0,0,0,0,0,0,1,1,1
Fiji,FJ,East Asia & Pacific,2021-01-05,passenger,250,0,170,170,420,195105.53434617378,2,0,1,1,3
Fiji,FJ,East Asia & Pacific,2021-01-06,passenger,269,0,888,888,1157,4116133.07290615,3,0,3,3,6
Fiji,FJ,East Asia & Pacific,2021-01-07,passenger,359,0,483,483,842,1206987.698539782,4,0,2,2,6
Fiji,FJ,East Asia & Pacific,2021-01-08,cargo,0,0,0,0,0,0,0,1,0,1,1
Fiji,FJ,East Asia & Pacific,2021-01-08,passenger,408,0,0,0,408,89888.80973412273,4,0,0,0,4
Fiji,FJ,East Asia & Pacific,2021-01-09,passenger,291,0,756,756,1047,2231131.235820747,2,0,3,3,5
Fiji,FJ,East Asia & Pacific,2021-01-10,cargo,0,0,0,0,0,0,0,1,0,1,1
Fiji,FJ,East Asia & Pacific,2021-01-10,passenger,296,0,306,306,602,698032.1247105419,3,0,2,2,5
Fiji,FJ,East Asia & Pacific,2021-01-11,cargo,0,0,0,0,0,0,0,0,1,1,1
Fiji,FJ,East Asia & Pacific,2021-01-11,passenger,271,0,273,273,544,904702.7955396572,4,0,1,1,5
Fiji,FJ,East Asia & Pacific,2021-01-12,cargo,0,0,0,0,0,0,0,0,1,1,1
Fiji,FJ,East Asia & Pacific,2021-01-12,passenger,250,0,0,0,250,30618.896486235775,2,0,0,0,2
Fiji,FJ,East Asia & Pacific,2021-01-13,cargo,0,0,0,0,0,0,0,1,0,1,1
Fiji,FJ,East Asia & Pacific,2021-01-13,passenger,206,0,861,861,1067,4052713.5525850407,2,0,3,3,5
Fiji,FJ,East Asia & Pacific,2021-01-14,passenger,421,0,483,483,904,928734.9299142011,6,0,2,2,8
Fiji,FJ,East Asia & Pacific,2021-01-15,cargo,0,0,0,0,0,0,0,1,0,1,1
Fiji,FJ,East Asia & Pacific,2021-01-15,passenger,432,0,0,0,432,92828.22379680135,4,0,0,0,4
Fiji,FJ,East Asia & Pacific,2021-01-16,cargo,0,0,0,0,0,0,0,0,1,1,1
Fiji,FJ,East Asia & Pacific,2021-01-16,passenger,247,0,381,381,628,773607.3066577455,2,0,2,2,4
Fiji,FJ,East Asia & Pacific,2021-01-17,cargo,0,0,0,0,0,0,0,1,0,1,1
Fiji,FJ,East Asia & Pacific,2021-01-17,passenger,432,0,0,0,432,69868.62043873892,4,0,0,0,4
Fiji,FJ,East Asia & Pacific,2021-01-18,cargo,0,0,0,0,0,0,0,0,1,1,1
Fiji,FJ,East Asia & Pacific,2021-01-18,passenger,320,0,68,68,388,126782.15133952755,4,0,1,1,5
Fiji,FJ,East Asia & Pacific,2021-01-19,passenger,307,0,483,483,790,872484.6470148038,3,0,2,2,5
Fiji,FJ,East Asia & Pacific,2021-01-20,cargo,0,0,0,0,0,0,0,1,1,2,2
Fiji,FJ,East Asia & Pacific,2021-01-20,passenger,250,0,302,302,552,679701.842817297,2,0,1,1,3
Fiji,FJ,East Asia & Pacific,2021-01-21,cargo,0,0,0,0,0,0,0,0,1,1,1
Fiji,FJ,East Asia & Pacific,2021-01-21,passenger,446,0,170,170,616,552099.3981397846,6,0,1,1,7
Fiji,FJ,East Asia & Pacific,2021-01-22,cargo,0,0,0,0,0,0,0,1,0,1,1
Fiji,FJ,East Asia & Pacific,2021-01-22,passenger,495,0,0,0,495,106696.73323364061,6,0,0,0,6
Fiji,FJ,East Asia & Pacific,2021-01-23,cargo,0,0,0,0,0,0,0,0,2,2,2
Fiji,FJ,East Asia & Pacific,2021-01-23,passenger,291,0,483,483,774,3264118.697054338,2,0,2,2,4
Fiji,FJ,East Asia & Pacific,2021-01-24,passenger,296,0,170,170,466,413371.29472191416,3,0,1,1,4
Fiji,FJ,East Asia & Pacific,2021-01-25,cargo,0,0,0,0,0,0,0,1,0,1,1
Fiji,FJ,East Asia & Pacific,2021-01-25,passenger,339,0,645,645,984,2094326.1261714068,4,0,2,2,6
Fiji,FJ,East Asia & Pacific,2021-01-26,cargo,0,0,0,0,0,0,0,0,1,1,1
Fiji,FJ,East Asia & Pacific,2021-01-26,passenger,250,0,313,313,563,703343.9368889581,2,0,1,1,3
Fiji,FJ,East Asia & Pacific,2021-01-27,cargo,0,0,0,0,0,0,0,1,1,2,2
Fiji,FJ,East Asia & Pacific,2021-01-27,passenger,114,0,615,615,729,3234117.0289913677,1,0,2,2,3
Fiji,FJ,East Asia & Pacific,2021-01-28,passenger,250,0,653,653,903,1032317.212608834,2,0,2,2,4
Fiji,FJ,East Asia & Pacific,2021-01-29,cargo,0,0,0,0,0,0,0,1,0,1,1
Fiji,FJ,East Asia & Pacific,2021-01-29,passenger,272,0,286,286,558,641490.1200737458,2,0,2,2,4
Fiji,FJ,East Asia & Pacific,2021-01-30,passenger,0,0,170,170,170,538868.4685658091,0,0,1,1,1
Fiji,FJ,East Asia & Pacific,2021-01-31,passenger,247,0,483,483,730,1550004.129452559,3,0,1,1,4
Fiji,FJ,East Asia & Pacific,2021-02-01,cargo,0,0,0,0,0,0,0,0,2,2,2
Fiji,FJ,East Asia & Pacific,2021-02-01,passenger,271,0,1010,1010,1281,2377455.6269201054,2,0,2,2,4
Fiji,FJ,East Asia & Pacific,2021-02-02,cargo,0,0,0,0,0,0,0,1,0,1,1
Fiji,FJ,East Asia & Pacific,2021-02-02,passenger,182,0,170,170,352,390929.4942689289,2,0,1,1,3
Fiji,FJ,East Asia & Pacific,2021-02-03,passenger,706,0,1312,1312,2018,5074729.796358782,3,0,4,4,7
Fiji,FJ,East Asia & Pacific,2021-02-04,cargo,0,0,0,0,0,0,0,0,1,1,1
Fiji,FJ,East Asia & Pacific,2021-02-04,passenger,296,0,483,483,779,1377990.759446472,3,0,1,1,4
Fiji,FJ,East Asia & Pacific,2021-02-05,cargo,0,0,0,0,0,0,0,1,0,1,1
Fiji,FJ,East Asia & Pacific,2021-02-05,passenger,616,0,0,0,616,102513.18673657927,7,0,0,0,7
Fiji,FJ,East Asia & Pacific,2021-02-06,cargo,0,0,0,0,0,0,0,0,1,1,1
Fiji,FJ,East Asia & Pacific,2021-02-06,passenger,291,0,381,381,672,1098423.1371018845,2,0,2,2,4
Fiji,FJ,East Asia & Pacific,2021-02-07,cargo,0,0,0,0,0,0,0,1,0,1,1
Fiji,FJ,East Asia & Pacific,2021-02-07,passenger,340,0,0,0,340,58600.866531804146,4,0,0,0,4
Fiji,FJ,East Asia & Pacific,2021-02-08,cargo,0,0,0,0,0,0,0,0,1,1,1
Fiji,FJ,East Asia & Pacific,2021-02-08,passenger,272,0,313,313,585,714517.9834350086,3,0,1,1,4
Fiji,FJ,East Asia & Pacific,2021-02-09,cargo,0,0,0,0,0,0,0,0,1,1,1
Fiji,FJ,East Asia & Pacific,2021-02-09,passenger,204,0,170,170,374,189471.6573927064,2,0,1,1,3
Fiji,FJ,East Asia & Pacific,2021-02-10,cargo,0,0,0,0,0,0,0,1,0,1,1
Fiji,FJ,East Asia & Pacific,2021-02-10,passenger,204,0,586,586,790,3461416.249621622,2,0,2,2,4
Fiji,FJ,East Asia & Pacific,2021-02-11,cargo,0,0,0,0,0,0,0,0,1,1,1
Fiji,FJ,East Asia & Pacific,2021-02-11,passenger,272,0,472,472,744,1079213.3101925373,3,0,1,1,4
Fiji,FJ,East Asia & Pacific,2021-02-12,passenger,476,0,170,170,646,271183.37109357864,5,0,1,1,6
Fiji,FJ,East Asia & Pacific,2021-02-13,cargo,0,0,0,0,0,0,0,1,1,2,2
Fiji,FJ,East Asia & Pacific,2021-02-13,passenger,155,0,551,551,706,1312890.6525367533,2,0,3,3,5
Fiji,FJ,East Asia & Pacific,2021-02-14,cargo,0,0,0,0,0,0,0,1,0,1,1
Fiji,FJ,East Asia & Pacific,2021-02-14,passenger,296,0,0,0,296,53211.940750226655,3,0,0,0,3
Fiji,FJ,East Asia & Pacific,2021-02-15,cargo,0,0,0,0,0,0,0,0,3,3,3
Fiji,FJ,East Asia & Pacific,2021-02-15,passenger,252,0,68,68,320,112967.0220712785,4,0,1,1,5
Fiji,FJ,East Asia & Pacific,2021-02-16,passenger,114,0,273,273,387,600716.006030769,1,0,1,1,2
Fiji,FJ,East Asia & Pacific,2021-02-17,passenger,298,273,302,575,873,3093284.4829857354,3,1,1,2,5
Fiji,FJ,East Asia & Pacific,2021-02-18,cargo,0,0,0,0,0,0,0,0,2,2,2
Fiji,FJ,East Asia & Pacific,2021-02-18,passenger,342,0,313,313,655,2633129.9493621434,4,0,1,1,5
Fiji,FJ,East Asia & Pacific,2021-02-19,cargo,0,0,0,0,0,0,0,1,0,1,1
Fiji,FJ,East Asia & Pacific,2021-02-19,passenger,340,0,0,0,340,90040.05354512834,5,0,0,0,5
Fiji,FJ,East Asia & Pacific,2021-02-20,cargo,0,0,0,0,0,0,0,0,1,1,1
Fiji,FJ,East Asia & Pacific,2021-02-20,passenger,249,0,313,313,562,691953.7073960784,3,0,1,1,4
Fiji,FJ,East Asia & Pacific,2021-02-21,cargo,0,0,0,0,0,0,0,1,0,1,1
Fiji,FJ,East Asia & Pacific,2021-02-21,passenger,546,0,313,313,859,2638001.072238644,5,0,1,1,6
Fiji,FJ,East Asia & Pacific,2021-02-22,cargo,0,0,0,0,0,0,0,0,1,1,1
Fiji,FJ,East Asia & Pacific,2021-02-22,passenger,250,0,477,477,727,1484634.7770502933,3,0,2,2,5
Fiji,FJ,East Asia & Pacific,2021-02-23,passenger,182,0,273,273,455,609044.3458750251,2,0,1,1,3
Fiji,FJ,East Asia & Pacific,2021-02-24,cargo,0,0,0,0,0,0,0,1,0,1,1
Fiji,FJ,East Asia & Pacific,2021-02-24,passenger,160,0,302,302,462,668679.0400822521,2,0,1,1,3
Fiji,FJ,East Asia & Pacific,2021-02-25,cargo,0,0,0,0,0,0,0,0,1,1,1
Fiji,FJ,East Asia & Pacific,2021-02-25,passenger,296,0,607,607,903,1450020.0923349105,3,0,3,3,6
Fiji,FJ,East Asia & Pacific,2021-02-26,cargo,0,0,0,0,0,0,0,1,0,1,1
Fiji,FJ,East Asia & Pacific,2021-02-26,passenger,543,0,0,0,543,101307.80745206309,6,0,0,0,6
Fiji,FJ,East Asia & Pacific,2021-02-27,cargo,0,0,0,0,0,0,0,0,1,1,1
Fiji,FJ,East Asia & Pacific,2021-02-27,passenger,368,0,651,651,1019,1376176.4590067263,3,0,3,3,6
Fiji,FJ,East Asia & Pacific,2021-02-28,passenger,521,0,0,0,521,92012.72128484637,10,0,0,0,10
Fiji,FJ,East Asia & Pacific,2021-03-01,cargo,0,0,0,0,0,0,0,1,0,1,1
Fiji,FJ,East Asia & Pacific,2021-03-01,passenger,799,0,505,505,1304,1327731.1736507642,10,0,3,3,13
Fiji,FJ,East Asia & Pacific,2021-03-02,cargo,0,0,0,0,0,0,0,0,2,2,2
Fiji,FJ,East Asia & Pacific,2021-03-02,passenger,652,0,341,341,993,761752.4490136517,9,0,2,2,11
Fiji,FJ,East Asia & Pacific,2021-03-03,cargo,0,0,0,0,0,0,0,0,1,1,1
Fiji,FJ,East Asia & Pacific,2021-03-03,passenger,622,0,477,477,1099,2815812.5643725093,8,0,2,2,10
Fiji,FJ,East Asia & Pacific,2021-03-04,cargo,0,0,0,0,0,0,0,0,1,1,1
Fiji,FJ,East Asia & Pacific,2021-03-04,passenger,773,0,901,901,1674,2277086.299710822,9,0,2,2,11
Fiji,FJ,East Asia & Pacific,2021-03-05,cargo,0,0,0,0,0,0,0,1,0,1,1
Fiji,FJ,East Asia & Pacific,2021-03-05,passenger,829,0,481,481,1310,2941508.5582667193,11,0,2,2,13
Fiji,FJ,East Asia & Pacific,2021-03-06,cargo,0,0,0,0,0,0,0,0,1,1,1
Fiji,FJ,East Asia & Pacific,2021-03-06,passenger,784,0,483,483,1267,1460981.6294401074,7,0,2,2,9
Fiji,FJ,East Asia & Pacific,2021-03-07,cargo,0,0,0,0,0,0,0,1,0,1,1
Fiji,FJ,East Asia & Pacific,2021-03-07,passenger,904,0,0,0,904,146901.39116453382,11,0,0,0,11
Fiji,FJ,East Asia & Pacific,2021-03-08,cargo,0,0,0,0,0,0,0,0,2,2,2
Fiji,FJ,East Asia & Pacific,2021-03-08,passenger,782,0,0,0,782,142020.7072604859,11,0,0,0,11
Fiji,FJ,East Asia & Pacific,2021-03-09,cargo,0,0,0,0,0,0,0,1,0,1,1
Fiji,FJ,East Asia & Pacific,2021-03-09,passenger,337,0,864,864,1201,3524976.6089175195,4,0,3,3,7
Fiji,FJ,East Asia & Pacific,2021-03-10,passenger,277,0,275,275,552,642851.7878710402,8,0,1,1,9
Fiji,FJ,East Asia & Pacific,2021-03-11,cargo,0,0,0,0,0,0,0,0,1,1,1
Fiji,FJ,East Asia & Pacific,2021-03-11,passenger,494,0,588,588,1082,1346173.6582395344,6,0,1,1,7
Fiji,FJ,East Asia & Pacific,2021-03-12,cargo,0,0,0,0,0,0,0,1,0,1,1
Fiji,FJ,East Asia & Pacific,2021-03-12,passenger,296,0,338,338,634,706687.7247003047,4,0,2,2,6
Fiji,FJ,East Asia & Pacific,2021-03-13,cargo,0,0,0,0,0,0,0,1,1,2,2
Fiji,FJ,East Asia & Pacific,2021-03-13,passenger,296,0,313,313,609,723414.0196197071,4,0,1,1,5
Fiji,FJ,East Asia & Pacific,2021-03-14,passenger,383,0,0,0,383,75414.57654512709,6,0,0,0,6
Fiji,FJ,East Asia & Pacific,2021-03-15,cargo,0,0,0,0,0,0,0,0,2,2,2
Fiji,FJ,East Asia & Pacific,2021-03-15,passenger,470,0,437,437,907,2499362.0007696347,7,0,2,2,9
Fiji,FJ,East Asia & Pacific,2021-03-16,cargo,0,0,0,0,0,0,0,0,1,1,1
Fiji,FJ,East Asia & Pacific,2021-03-16,passenger,0,0,551,551,551,3005505.4586335076,0,0,3,3,3
Fiji,FJ,East Asia & Pacific,2021-03-17,passenger,0,0,472,472,472,1059907.5469282276,0,0,2,2,2
Fiji,FJ,East Asia & Pacific,2021-03-18,cargo,0,0,0,0,0,0,0,1,1,2,2
Fiji,FJ,East Asia & Pacific,2021-03-18,passenger,0,0,483,483,483,837211.6782626603,0,0,2,2,2
Fiji,FJ,East Asia & Pacific,2021-03-19,cargo,0,0,0,0,0,0,0,0,1,1,1
Fiji,FJ,East Asia & Pacific,2021-03-19,passenger,291,0,0,0,291,60479.30757535783,4,0,0,0,4
Fiji,FJ,East Asia & Pacific,2021-03-20,cargo,0,0,0,0,0,0,0,0,1,1,1
Fiji,FJ,East Asia & Pacific,2021-03-20,passenger,361,0,483,483,844,1590134.360418812,7,0,1,1,8
Fiji,FJ,East Asia & Pacific,2021-03-21,passenger,570,0,0,0,570,95536.67448196643,7,0,0,0,7
Fiji,FJ,East Asia & Pacific,2021-03-22,cargo,0,0,0,0,0,0,0,1,1,2,2
Fiji,FJ,East Asia & Pacific,2021-03-22,passenger,755,0,443,443,1198,889996.2673751968,11,0,2,2,13
Fiji,FJ,East Asia & Pacific,2021-03-23,cargo,0,0,0,0,0,0,0,0,1,1,1
Fiji,FJ,East Asia & Pacific,2021-03-23,passenger,526,0,313,313,839,1077629.1566024346,7,0,1,1,8
Fiji,FJ,East Asia & Pacific,2021-03-24,cargo,0,0,0,0,0,0,0,1,0,1,1
Fiji,FJ,East Asia & Pacific,2021-03-24,passenger,556,0,0,0,556,93755.61591023776,8,0,0,0,8
Fiji,FJ,East Asia & Pacific,2021-03-25,cargo,0,0,0,0,0,0,0,0,2,2,2
Fiji,FJ,East Asia & Pacific,2021-03-25,passenger,611,0,949,949,1560,1957713.6672680576,9,0,2,2,11
Fiji,FJ,East Asia & Pacific,2021-03-26,cargo,0,0,0,0,0,0,0,1,0,1,1
Fiji,FJ,East Asia & Pacific,2021-03-26,passenger,801,0,170,170,971,589777.010740569,9,0,1,1,10
Fiji,FJ,East Asia & Pacific,2021-03-27,cargo,0,0,0,0,0,0,0,0,1,1,1
Fiji,FJ,East Asia & Pacific,2021-03-27,passenger,358,0,553,553,911,1136038.3989975336,3,0,3,3,6
Fiji,FJ,East Asia & Pacific,2021-03-28,passenger,584,0,0,0,584,101697.41685127326,9,0,0,0,9
Fiji,FJ,East Asia & Pacific,2021-03-29,cargo,0,0,0,0,0,0,0,1,0,1,1
Fiji,FJ,East Asia & Pacific,2021-03-29,passenger,780,0,586,586,1366,1720047.145662289,9,0,2,2,11
Fiji,FJ,East Asia & Pacific,2021-03-30,passenger,633,0,654,654,1287,1704804.6600365113,8,0,3,3,11
Fiji,FJ,East Asia & Pacific,2021-03-31,passenger,712,0,615,615,1327,3342556.279896078,8,0,2,2,10
Fiji,FJ,East Asia & Pacific,2021-04-01,passenger,628,0,756,756,1384,1837680.978963907,9,0,3,3,12
Fiji,FJ,East Asia & Pacific,2021-04-02,cargo,0,0,0,0,0,0,0,1,0,1,1
Fiji,FJ,East Asia & Pacific,2021-04-02,passenger,410,0,313,313,723,2659513.7087430763,5,0,1,1,6
Fiji,FJ,East Asia & Pacific,2021-04-03,cargo,0,0,0,0,0,0,0,0,1,1,1
Fiji,FJ,East Asia & Pacific,2021-04-03,passenger,179,0,437,437,616,1128526.5005571474,2,0,2,2,4
Fiji,FJ,East Asia & Pacific,2021-04-04,cargo,0,0,0,0,0,0,0,1,0,1,1
Fiji,FJ,East Asia & Pacific,2021-04-04,passenger,203,0,164,164,367,382489.6699434658,3,0,1,1,4
Fiji,FJ,East Asia & Pacific,2021-04-05,cargo,0,0,0,0,0,0,0,0,1,1,1
Fiji,FJ,East Asia & Pacific,2021-04-05,passenger,334,0,273,273,607,645826.0017938451,6,0,1,1,7
Fiji,FJ,East Asia & Pacific,2021-04-06,cargo,0,0,0,0,0,0,0,0,1,1,1
Fiji,FJ,East Asia & Pacific,2021-04-06,passenger,318,0,341,341,659,2058785.795624637,4,0,2,2,6
Fiji,FJ,East Asia & Pacific,2021-04-07,passenger,206,0,313,313,519,2596301.8365672417,2,0,1,1,3
Fiji,FJ,East Asia & Pacific,2021-04-08,passenger,138,0,1331,1331,1469,2940113.295901239,2,0,6,6,8
Fiji,FJ,East Asia & Pacific,2021-04-09,cargo,0,0,0,0,0,0,0,1,1,2,2
Fiji,FJ,East Asia & Pacific,2021-04-09,passenger,429,0,286,286,715,798282.829819115,6,0,2,2,8
Fiji,FJ,East Asia & Pacific,2021-04-10,cargo,0,0,0,0,0,0,0,0,1,1,1
Fiji,FJ,East Asia & Pacific,2021-04-10,passenger,271,0,313,313,584,1032153.871852376,4,0,1,1,5
Fiji,FJ,East Asia & Pacific,2021-04-11,cargo,0,0,0,0,0,0,0,1,0,1,1
Fiji,FJ,East Asia & Pacific,2021-04-11,passenger,497,0,0,0,497,94264.71370602744,7,0,0,0,7
Fiji,FJ,East Asia & Pacific,2021-04-12,cargo,0,0,0,0,0,0,0,0,2,2,2
Fiji,FJ,East Asia & Pacific,2021-04-12,passenger,182,0,273,273,455,887649.9208682496,2,0,1,1,3
Fiji,FJ,East Asia & Pacific,2021-04-13,cargo,0,0,0,0,0,0,0,0,1,1,1
Fiji,FJ,East Asia & Pacific,2021-04-13,passenger,250,0,68,68,318,96413.55163021096,2,0,1,1,3
Fiji,FJ,East Asia & Pacific,2021-04-14,passenger,225,0,313,313,538,2598628.8727001958,2,0,1,1,3
Fiji,FJ,East Asia & Pacific,2021-04-15,cargo,0,0,0,0,0,0,0,1,1,2,2
Fiji,FJ,East Asia & Pacific,2021-04-15,passenger,206,0,548,548,754,1224303.7970617758,3,0,1,1,4
Fiji,FJ,East Asia & Pacific,2021-04-16,cargo,0,0,0,0,0,0,0,1,0,1,1
Fiji,FJ,East Asia & Pacific,2021-04-16,passenger,405,0,762,762,1167,3721986.7903168057,5,0,3,3,8
Fiji,FJ,East Asia & Pacific,2021-04-17,cargo,0,0,0,0,0,0,0,0,1,1,1
Fiji,FJ,East Asia & Pacific,2021-04-17,passenger,157,0,313,313,470,1011380.6120586399,2,0,1,1,3
Fiji,FJ,East Asia & Pacific,2021-04-18,cargo,0,0,0,0,0,0,0,1,0,1,1
Fiji,FJ,East Asia & Pacific,2021-04-18,passenger,228,0,214,214,442,504829.7946637424,4,0,1,1,5
Fiji,FJ,East Asia & Pacific,2021-04-19,cargo,0,0,0,0,0,0,0,0,2,2,2
Fiji,FJ,East Asia & Pacific,2021-04-19,passenger,38,0,313,313,351,996806.0173311917,2,0,1,1,3
Fiji,FJ,East Asia & Pacific,2021-04-20,cargo,0,0,0,0,0,0,0,0,1,1,1
Fiji,FJ,East Asia & Pacific,2021-04-20,passenger,38,0,68,68,106,70448.72740988302,2,0,1,1,3
Fiji,FJ,East Asia & Pacific,2021-04-21,cargo,0,0,0,0,0,0,0,1,0,1,1
Fiji,FJ,East Asia & Pacific,2021-04-21,passenger,19,0,313,313,332,2573398.9019955373,1,0,1,1,2
Fiji,FJ,East Asia & Pacific,2021-04-22,cargo,0,0,0,0,0,0,0,0,1,1,1
Fiji,FJ,East Asia & Pacific,2021-04-22,passenger,65,0,758,758,823,1755651.8478031722,1,0,3,3,4
Fiji,FJ,East Asia & Pacific,2021-04-23,cargo,0,0,0,0,0,0,0,1,0,1,1
Fiji,FJ,East Asia & Pacific,2021-04-23,passenger,106,0,0,0,106,15566.160101935877,3,0,0,0,3
Fiji,FJ,East Asia & Pacific,2021-04-24,cargo,0,0,0,0,0,0,0,0,1,1,1
Fiji,FJ,East Asia & Pacific,2021-04-24,passenger,106,0,313,313,419,1009946.425767875,3,0,1,1,4
Fiji,FJ,East Asia & Pacific,2021-04-25,passenger,19,0,0,0,19,2327.0361329539187,1,0,0,0,1
Fiji,FJ,East Asia & Pacific,2021-04-26,cargo,0,0,0,0,0,0,0,1,1,2,2
Fiji,FJ,East Asia & Pacific,2021-04-26,passenger,38,0,273,273,311,591407.8614989533,2,0,1,1,3
Fiji,FJ,East Asia & Pacific,2021-04-27,cargo,0,0,0,0,0,0,0,0,2,2,2
Fiji,FJ,East Asia & Pacific,2021-04-27,passenger,376,0,273,273,649,880301.385711553,3,0,1,1,4
Fiji,FJ,East Asia & Pacific,2021-04-28,passenger,106,0,313,313,419,2584054.2779727476,2,0,1,1,3
Fiji,FJ,East Asia & Pacific,2021-04-29,cargo,0,0,0,0,0,0,0,0,1,1,1
Fiji,FJ,East Asia & Pacific,2021-04-29,passenger,57,0,785,785,842,1493275.7329925832,2,0,2,2,4
Fiji,FJ,East Asia & Pacific,2021-04-30,cargo,0,0,0,0,0,0,0,1,0,1,1
Fiji,FJ,East Asia & Pacific,2021-04-30,passenger,19,0,0,0,19,2327.0361329539187,1,0,0,0,1
Fiji,FJ,East Asia & Pacific,2021-05-01,cargo,0,0,0,0,0,0,0,0,1,1,1
Fiji,FJ,East Asia & Pacific,2021-05-01,passenger,38,0,313,313,351,677379.1126686302,2,0,1,1,3
Fiji,FJ,East Asia & Pacific,2021-05-02,cargo,0,0,0,0,0,0,0,1,0,1,1
Fiji,FJ,East Asia & Pacific,2021-05-02,passenger,38,0,313,313,351,2575725.9381284914,2,0,1,1,3
Fiji,FJ,East Asia & Pacific,2021-05-03,cargo,0,0,0,0,0,0,0,0,1,1,1
Fiji,FJ,East Asia & Pacific,2021-05-03,passenger,38,0,273,273,311,591407.8614989533,2,0,1,1,3
Fiji,FJ,East Asia & Pacific,2021-05-04,passenger,292,0,381,381,673,743173.7678126054,3,0,2,2,5
Fiji,FJ,East Asia & Pacific,2021-05-05,cargo,0,0,0,0,0,0,0,1,0,1,1
Fiji,FJ,East Asia & Pacific,2021-05-05,passenger,57,0,0,0,57,4654.072265907837,3,0,0,0,3
Fiji,FJ,East Asia & Pacific,2021-05-06,cargo,0,0,0,0,0,0,0,0,1,1,1
Fiji,FJ,East Asia & Pacific,2021-05-06,passenger,19,0,1058,1058,1077,3971395.2392866276,1,0,3,3,4
Fiji,FJ,East Asia & Pacific,2021-05-07,cargo,0,0,0,0,0,0,0,1,0,1,1
Fiji,FJ,East Asia & Pacific,2021-05-07,passenger,19,0,0,0,19,2327.0361329539187,1,0,0,0,1
Fiji,FJ,East Asia & Pacific,2021-05-08,passenger,68,0,586,586,654,1546412.7444732483,1,0,2,2,3
Fiji,FJ,East Asia & Pacific,2021-05-09,passenger,136,313,170,483,619,3165154.6049667085,2,1,1,2,4
Fiji,FJ,East Asia & Pacific,2021-05-10,cargo,0,0,0,0,0,0,0,0,1,1,1
Fiji,FJ,East Asia & Pacific,2021-05-10,passenger,38,0,750,750,788,2568150.62252918,2,0,3,3,5
Fiji,FJ,East Asia & Pacific,2021-05-11,passenger,76,0,654,654,730,1608533.132038875,3,0,3,3,6
Fiji,FJ,East Asia & Pacific,2021-05-12,passenger,57,0,313,313,370,2578774.9038473815,3,0,1,1,4
Fiji,FJ,East Asia & Pacific,2021-05-13,cargo,0,0,0,0,0,0,0,1,1,2,2
Fiji,FJ,East Asia & Pacific,2021-05-13,passenger,38,0,683,683,721,1392256.7141436664,2,0,2,2,4
Fiji,FJ,East Asia & Pacific,2021-05-14,cargo,0,0,0,0,0,0,0,1,0,1,1
Fiji,FJ,East Asia & Pacific,2021-05-14,passenger,0,0,273,273,273,865359.3642262699,0,0,1,1,1
Fiji,FJ,East Asia & Pacific,2021-05-15,cargo,0,0,0,0,0,0,0,0,1,1,1
Fiji,FJ,East Asia & Pacific,2021-05-15,passenger,0,0,273,273,273,865359.3642262699,0,0,1,1,1
Fiji,FJ,East Asia & Pacific,2021-05-16,cargo,0,0,0,0,0,0,0,1,0,1,1
Fiji,FJ,East Asia & Pacific,2021-05-17,cargo,0,0,0,0,0,0,0,0,2,2,2
Fiji,FJ,East Asia & Pacific,2021-05-18,cargo,0,0,0,0,0,0,0,0,1,1,1
Fiji,FJ,East Asia & Pacific,2021-05-18,passenger,19,0,341,341,360,2006550.9766938714,1,0,2,2,3
Fiji,FJ,East Asia & Pacific,2021-05-19,cargo,0,0,0,0,0,0,0,1,0,1,1
Fiji,FJ,East Asia & Pacific,2021-05-20,cargo,0,0,0,0,0,0,0,0,1,1,1
Fiji,FJ,East Asia & Pacific,2021-05-20,passenger,38,0,443,443,481,755894.4993588913,2,0,2,2,4
Fiji,FJ,East Asia & Pacific,2021-05-21,cargo,0,0,0,0,0,0,0,1,0,1,1
Fiji,FJ,East Asia & Pacific,2021-05-22,cargo,0,0,0,0,0,0,0,0,1,1,1
Fiji,FJ,East Asia & Pacific,2021-05-22,passenger,0,0,273,273,273,586753.7892330454,0,0,1,1,1
Fiji,FJ,East Asia & Pacific,2021-05-23,cargo,0,0,0,0,0,0,0,1,0,1,1
Fiji,FJ,East Asia & Pacific,2021-05-23,passenger,0,0,313,313,313,2571071.8658625833,0,0,1,1,1
Fiji,FJ,East Asia & Pacific,2021-05-24,cargo,0,0,0,0,0,0,0,0,1,1,1
Fiji,FJ,East Asia & Pacific,2021-05-24,passenger,0,0,273,273,273,586753.7892330454,0,0,1,1,1
Fiji,FJ,East Asia & Pacific,2021-05-25,passenger,114,0,313,313,427,672725.0404027223,1,0,1,1,2
Fiji,FJ,East Asia & Pacific,2021-05-26,cargo,0,0,0,0,0,0,0,0,1,1,1
Fiji,FJ,East Asia & Pacific,2021-05-27,passenger,38,170,861,1031,1069,2998993.479190291,2,1,2,3,5
Fiji,FJ,East Asia & Pacific,2021-05-28,cargo,0,0,0,0,0,0,0,1,0,1,1
Fiji,FJ,East Asia & Pacific,2021-05-28,passenger,38,0,0,0,38,4654.072265907837,2,0,0,0,2
Fiji,FJ,East Asia & Pacific,2021-05-29,passenger,0,170,586,756,756,2403287.0551328533,0,1,2,3,3
Fiji,FJ,East Asia & Pacific,2021-05-30,cargo,0,0,0,0,0,0,0,1,0,1,1
Fiji,FJ,East Asia & Pacific,2021-05-30,passenger,38,0,0,0,38,4654.072265907837,2,0,0,0,2
Fiji,FJ,East Asia & Pacific,2021-05-31,cargo,0,0,0,0,0,0,0,0,2,2,2
Fiji,FJ,East Asia & Pacific,2021-06-01,cargo,0,0,0,0,0,0,1,0,0,0,1
Fiji,FJ,East Asia & Pacific,2021-06-01,passenger,38,0,654,654,692,2675604.4323863443,1,0,3,3,4
Fiji,FJ,East Asia & Pacific,2021-06-02,cargo,0,0,0,0,0,0,0,1,0,1,1
Fiji,FJ,East Asia & Pacific,2021-06-02,passenger,38,0,313,313,351,2571071.8658625833,1,0,1,1,2
Fiji,FJ,East Asia & Pacific,2021-06-03,cargo,0,0,0,0,0,0,0,0,1,1,1
Fiji,FJ,East Asia & Pacific,2021-06-03,passenger,38,0,785,785,823,1486294.6245937215,1,0,2,2,3
Fiji,FJ,East Asia & Pacific,2021-06-04,cargo,0,0,0,0,0,0,0,1,0,1,1
Fiji,FJ,East Asia & Pacific,2021-06-04,passenger,0,0,340,340,340,922363.5438049093,0,0,1,1,1
Fiji,FJ,East Asia & Pacific,2021-06-05,cargo,0,0,0,0,0,0,0,0,1,1,1
Fiji,FJ,East Asia & Pacific,2021-06-05,passenger,0,0,313,313,313,672725.0404027223,0,0,1,1,1
Fiji,FJ,East Asia & Pacific,2021-06-06,cargo,0,0,0,0,0,0,0,1,0,1,1
Fiji,FJ,East Asia & Pacific,2021-06-06,passenger,38,0,0,0,38,4654.072265907837,2,0,0,0,2
Fiji,FJ,East Asia & Pacific,2021-06-07,cargo,0,0,0,0,0,0,0,0,2,2,2
Fiji,FJ,East Asia & Pacific,2021-06-08,cargo,0,0,0,0,0,0,0,0,1,1,1
Fiji,FJ,East Asia & Pacific,2021-06-08,passenger,19,0,0,0,19,2327.0361329539187,1,0,0,0,1
Fiji,FJ,East Asia & Pacific,2021-06-09,passenger,0,0,313,313,313,2571071.8658625833,0,0,1,1,1
Fiji,FJ,East Asia & Pacific,2021-06-10,cargo,0,0,0,0,0,0,0,0,1,1,1
Fiji,FJ,East Asia & Pacific,2021-06-10,passenger,254,0,861,861,1115,3231970.9278639136,1,0,2,2,3
Fiji,FJ,East Asia & Pacific,2021-06-11,passenger,19,0,0,0,19,2327.0361329539187,1,0,0,0,1
Fiji,FJ,East Asia & Pacific,2021-06-12,cargo,0,0,0,0,0,0,0,1,1,2,2
Fiji,FJ,East Asia & Pacific,2021-06-12,passenger,0,313,273,586,586,3645218.3518775166,0,1,1,2,2
Fiji,FJ,East Asia & Pacific,2021-06-13,cargo,0,0,0,0,0,0,0,1,1,2,2
Fiji,FJ,East Asia & Pacific,2021-06-14,passenger,0,0,483,483,483,1211593.5089685314,0,0,2,2,2
Fiji,FJ,East Asia & Pacific,2021-06-15,cargo,0,0,0,0,0,0,0,0,1,1,1
Fiji,FJ,East Asia & Pacific,2021-06-15,passenger,19,0,381,381,400,740846.7316796514,1,0,2,2,3
Fiji,FJ,East Asia & Pacific,2021-06-16,cargo,0,0,0,0,0,0,0,1,0,1,1
Fiji,FJ,East Asia & Pacific,2021-06-16,passenger,19,0,313,313,332,2573398.9019955373,1,0,1,1,2
Fiji,FJ,East Asia & Pacific,2021-06-17,passenger,273,0,888,888,1161,2189494.3870930076,2,0,2,2,4
Fiji,FJ,East Asia & Pacific,2021-06-18,cargo,0,0,0,0,0,0,0,1,0,1,1
Fiji,FJ,East Asia & Pacific,2021-06-18,passenger,19,0,273,273,292,865359.3642262699,1,0,1,1,2
Fiji,FJ,East Asia & Pacific,2021-06-19,passenger,19,0,586,586,605,1538084.404628992,1,0,2,2,3
Fiji,FJ,East Asia & Pacific,2021-06-20,cargo,0,0,0,0,0,0,0,1,0,1,1
Fiji,FJ,East Asia & Pacific,2021-06-20,passenger,19,0,0,0,19,2327.0361329539187,1,0,0,0,1
Fiji,FJ,East Asia & Pacific,2021-06-21,cargo,0,0,0,0,0,0,0,0,1,1,1
Fiji,FJ,East Asia & Pacific,2021-06-21,passenger,0,0,273,273,273,586753.7892330454,0,0,1,1,1
Fiji,FJ,East Asia & Pacific,2021-06-22,passenger,19,0,586,586,605,1540411.440761946,1,0,2,2,3
Fiji,FJ,East Asia & Pacific,2021-06-23,passenger,0,0,273,273,273,1937084.7368396465,0,0,1,1,1
Fiji,FJ,East Asia & Pacific,2021-06-24,cargo,0,0,0,0,0,0,0,1,1,2,2
Fiji,FJ,East Asia & Pacific,2021-06-24,passenger,38,0,756,756,794,3605571.9402146987,1,0,3,3,4
Fiji,FJ,East Asia & Pacific,2021-06-25,cargo,0,0,0,0,0,0,0,1,0,1,1
Fiji,FJ,East Asia & Pacific,2021-06-26,cargo,0,0,0,0,0,0,0,0,1,1,1
Fiji,FJ,East Asia & Pacific,2021-06-26,passenger,0,0,302,302,302,649082.9463310612,0,0,1,1,1
Fiji,FJ,East Asia & Pacific,2021-06-27,cargo,0,0,0,0,0,0,0,1,0,1,1
Fiji,FJ,East Asia & Pacific,2021-06-27,passenger,0,0,313,313,313,672725.0404027223,0,0,1,1,1
Fiji,FJ,East Asia & Pacific,2021-06-28,cargo,0,0,0,0,0,0,0,0,1,1,1
Fiji,FJ,East Asia & Pacific,2021-06-28,passenger,92,0,540,540,632,1311080.4545151358,1,0,2,2,3
Fiji,FJ,East Asia & Pacific,2021-06-29,cargo,0,0,0,0,0,0,0,0,1,1,1
Fiji,FJ,East Asia & Pacific,2021-06-29,passenger,19,0,608,608,627,1657807.7207852893,1,0,3,3,4
Fiji,FJ,East Asia & Pacific,2021-06-30,cargo,0,0,0,0,0,0,0,1,1,2,2
Fiji,FJ,East Asia & Pacific,2021-07-01,passenger,0,0,756,756,756,1702571.0424889303,0,0,3,3,3
Fiji,FJ,East Asia & Pacific,2021-07-02,cargo,0,0,0,0,0,0,0,1,0,1,1
Fiji,FJ,East Asia & Pacific,2021-07-03,cargo,0,0,0,0,0,0,0,0,1,1,1
Fiji,FJ,East Asia & Pacific,2021-07-03,passenger,0,0,615,615,615,1321807.9867337835,0,0,1,1,1
Fiji,FJ,East Asia & Pacific,2021-07-04,cargo,0,0,0,0,0,0,0,1,0,1,1
Fiji,FJ,East Asia & Pacific,2021-07-04,passenger,0,170,0,170,170,865202.6505038614,0,1,0,1,1
Fiji,FJ,East Asia & Pacific,2021-07-05,cargo,0,0,0,0,0,0,0,0,1,1,1
Fiji,FJ,East Asia & Pacific,2021-07-05,passenger,0,0,441,441,441,732635.7151019797,0,0,2,2,2
Fiji,FJ,East Asia & Pacific,2021-07-06,passenger,0,0,586,586,586,1538084.404628992,0,0,2,2,2
Fiji,FJ,East Asia & Pacific,2021-07-07,cargo,0,0,0,0,0,0,0,1,0,1,1
Fiji,FJ,East Asia & Pacific,2021-07-07,passenger,19,0,313,313,332,2573398.9019955373,1,0,1,1,2
Fiji,FJ,East Asia & Pacific,2021-07-08,cargo,0,0,0,0,0,0,0,0,1,1,1
Fiji,FJ,East Asia & Pacific,2021-07-08,passenger,0,0,483,483,483,1156638.5829252219,0,0,2,2,2
Fiji,FJ,East Asia & Pacific,2021-07-09,cargo,0,0,0,0,0,0,0,1,0,1,1
Fiji,FJ,East Asia & Pacific,2021-07-09,passenger,0,0,313,313,313,2220906.676303331,0,0,1,1,1
Fiji,FJ,East Asia & Pacific,2021-07-10,cargo,0,0,0,0,0,0,0,0,1,1,1
Fiji,FJ,East Asia & Pacific,2021-07-10,passenger,19,0,273,273,292,589080.8253659994,1,0,1,1,2
Fiji,FJ,East Asia & Pacific,2021-07-11,cargo,0,0,0,0,0,0,0,1,0,1,1
Fiji,FJ,East Asia & Pacific,2021-07-12,cargo,0,0,0,0,0,0,0,0,1,1,1
Fiji,FJ,East Asia & Pacific,2021-07-12,passenger,38,0,548,548,586,1180133.1771575285,2,0,1,1,3
Fiji,FJ,East Asia & Pacific,2021-07-13,passenger,0,0,654,654,654,1603879.0597729674,0,0,3,3,3
Fiji,FJ,East Asia & Pacific,2021-07-14,passenger,0,0,313,313,313,2571071.8658625833,0,0,1,1,1
Fiji,FJ,East Asia & Pacific,2021-07-15,cargo,0,0,0,0,0,0,0,1,0,1,1
Fiji,FJ,East Asia & Pacific,2021-07-15,passenger,46,0,483,483,529,837211.6782626603,1,0,2,2,3
Fiji,FJ,East Asia & Pacific,2021-07-16,cargo,0,0,0,0,0,0,0,1,0,1,1
Fiji,FJ,East Asia & Pacific,2021-07-16,passenger,133,0,273,273,406,876014.7402034799,2,0,1,1,3
Fiji,FJ,East Asia & Pacific,2021-07-17,passenger,38,0,1201,1201,1239,2864588.722928818,2,0,2,2,4
Fiji,FJ,East Asia & Pacific,2021-07-18,cargo,0,0,0,0,0,0,0,1,0,1,1
Fiji,FJ,East Asia & Pacific,2021-07-18,passenger,46,0,0,0,46,5633.876953467382,1,0,0,0,1
Fiji,FJ,East Asia & Pacific,2021-07-19,passenger,46,0,586,586,632,1584539.6112517968,1,0,2,2,3
Fiji,FJ,East Asia & Pacific,2021-07-20,passenger,111,0,586,586,697,1540411.440761946,2,0,2,2,4
Fiji,FJ,East Asia & Pacific,2021-07-21,cargo,0,0,0,0,0,0,0,1,0,1,1
Fiji,FJ,East Asia & Pacific,2021-07-21,passenger,157,0,313,313,470,2590300.532855939,1,0,1,1,2
Fiji,FJ,East Asia & Pacific,2021-07-22,cargo,0,0,0,0,0,0,0,0,1,1,1
Fiji,FJ,East Asia & Pacific,2021-07-22,passenger,138,0,170,170,308,181388.26872034016,1,0,1,1,2
Fiji,FJ,East Asia & Pacific,2021-07-23,cargo,0,0,0,0,0,0,0,1,0,1,1
Fiji,FJ,East Asia & Pacific,2021-07-23,passenger,111,0,313,313,424,686319.830442611,1,0,1,1,2
Fiji,FJ,East Asia & Pacific,2021-07-24,passenger,0,0,861,861,861,2129136.7564205215,0,0,2,2,2
Fiji,FJ,East Asia & Pacific,2021-07-25,cargo,0,0,0,0,0,0,0,1,0,1,1
Fiji,FJ,East Asia & Pacific,2021-07-26,cargo,0,0,0,0,0,0,0,0,1,1,1
Fiji,FJ,East Asia & Pacific,2021-07-26,passenger,19,0,0,0,19,2327.0361329539187,1,0,0,0,1
Fiji,FJ,East Asia & Pacific,2021-07-27,passenger,0,0,654,654,654,1603879.0597729674,0,0,3,3,3
Fiji,FJ,East Asia & Pacific,2021-07-28,cargo,0,0,0,0,0,0,0,1,0,1,1
Fiji,FJ,East Asia & Pacific,2021-07-28,passenger,68,0,481,481,549,2940479.4606194827,1,0,2,2,3
Fiji,FJ,East Asia & Pacific,2021-07-29,cargo,0,0,0,0,0,0,0,0,1,1,1
Fiji,FJ,East Asia & Pacific,2021-07-29,passenger,87,0,586,586,673,2620465.1532195793,2,0,2,2,4
Fiji,FJ,East Asia & Pacific,2021-07-30,cargo,0,0,0,0,0,0,0,1,0,1,1
Fiji,FJ,East Asia & Pacific,2021-07-30,passenger,19,0,0,0,19,2327.0361329539187,1,0,0,0,1
Fiji,FJ,East Asia & Pacific,2021-07-31,passenger,0,0,888,888,888,2187167.3509600535,0,0,2,2,2
Fiji,FJ,East Asia & Pacific,2021-08-01,cargo,0,0,0,0,0,0,0,1,0,1,1
Fiji,FJ,East Asia & Pacific,2021-08-02,cargo,0,0,0,0,0,0,0,0,1,1,1
Fiji,FJ,East Asia & Pacific,2021-08-03,passenger,19,0,586,586,605,1540411.440761946,1,0,2,2,3
Fiji,FJ,East Asia & Pacific,2021-08-04,passenger,0,0,313,313,313,2571071.8658625833,0,0,1,1,1
Fiji,FJ,East Asia & Pacific,2021-08-05,passenger,92,0,756,756,848,1702571.0424889303,1,0,3,3,4
Fiji,FJ,East Asia & Pacific,2021-08-06,passenger,111,0,273,273,384,2244827.417540255,2,0,1,1,3
Fiji,FJ,East Asia & Pacific,2021-08-07,passenger,0,0,888,888,888,2187167.3509600535,0,0,2,2,2
Fiji,FJ,East Asia & Pacific,2021-08-08,cargo,0,0,0,0,0,0,0,1,0,1,1
Fiji,FJ,East Asia & Pacific,2021-08-08,passenger,46,0,297,297,343,805711.6838531119,1,0,1,1,2
Fiji,FJ,East Asia & Pacific,2021-08-09,cargo,0,0,0,0,0,0,0,0,1,1,1
Fiji,FJ,East Asia & Pacific,2021-08-09,passenger,46,313,441,754,800,3727692.031796935,1,1,1,2,3
Fiji,FJ,East Asia & Pacific,2021-08-10,passenger,19,0,313,313,332,675052.0765356763,1,0,1,1,2
Fiji,FJ,East Asia & Pacific,2021-08-11,cargo,0,0,0,0,0,0,0,1,0,1,1
Fiji,FJ,East Asia & Pacific,2021-08-11,passenger,46,0,586,586,632,3442065.1070423205,1,0,2,2,3
Fiji,FJ,East Asia & Pacific,2021-08-12,passenger,46,0,756,756,802,1708204.9194423978,1,0,3,3,4
Fiji,FJ,East Asia & Pacific,2021-08-13,cargo,0,0,0,0,0,0,0,1,1,2,2
Fiji,FJ,East Asia & Pacific,2021-08-13,passenger,84,0,170,170,254,463508.8080354086,2,0,1,1,3
Fiji,FJ,East Asia & Pacific,2021-08-14,cargo,0,0,0,0,0,0,0,0,1,1,1
Fiji,FJ,East Asia & Pacific,2021-08-14,passenger,46,0,0,0,46,0,1,0,0,0,1
Fiji,FJ,East Asia & Pacific,2021-08-15,cargo,0,0,0,0,0,0,0,1,0,1,1
Fiji,FJ,East Asia & Pacific,2021-08-15,passenger,46,0,174,174,220,472033.1077119242,1,0,1,1,2
Fiji,FJ,East Asia & Pacific,2021-08-16,cargo,0,0,0,0,0,0,0,0,1,1,1
Fiji,FJ,East Asia & Pacific,2021-08-16,passenger,46,0,302,302,348,649082.9463310612,1,0,1,1,2
Fiji,FJ,East Asia & Pacific,2021-08-17,passenger,19,0,313,313,332,675052.0765356763,1,0,1,1,2
Fiji,FJ,East Asia & Pacific,2021-08-18,passenger,0,0,313,313,313,2571071.8658625833,0,0,1,1,1
Fiji,FJ,East Asia & Pacific,2021-08-19,passenger,92,0,756,756,848,1893910.442114777,1,0,3,3,4
Fiji,FJ,East Asia & Pacific,2021-08-20,cargo,0,0,0,0,0,0,0,1,0,1,1
Fiji,FJ,East Asia & Pacific,2021-08-20,passenger,68,0,238,238,306,540140.9082733331,1,0,2,2,3
Fiji,FJ,East Asia & Pacific,2021-08-21,cargo,0,0,0,0,0,0,0,0,1,1,1
Fiji,FJ,East Asia & Pacific,2021-08-21,passenger,19,0,853,853,872,3885338.3897677627,1,0,3,3,4
Fiji,FJ,East Asia & Pacific,2021-08-22,passenger,38,0,0,0,38,995.7481046003286,1,0,0,0,1
Fiji,FJ,East Asia & Pacific,2021-08-23,cargo,0,0,0,0,0,0,0,1,0,1,1
Fiji,FJ,East Asia & Pacific,2021-08-23,passenger,19,0,861,861,880,2169958.0860898583,1,0,2,2,3
Fiji,FJ,East Asia & Pacific,2021-08-24,passenger,19,0,313,313,332,675052.0765356763,1,0,1,1,2
Fiji,FJ,East Asia & Pacific,2021-08-25,cargo,0,0,0,0,0,0,0,1,0,1,1
Fiji,FJ,East Asia & Pacific,2021-08-25,passenger,0,0,313,313,313,2571071.8658625833,0,0,1,1,1
Fiji,FJ,East Asia & Pacific,2021-08-26,passenger,0,0,756,756,756,1893910.442114777,0,0,3,3,3
Fiji,FJ,East Asia & Pacific,2021-08-27,cargo,0,0,0,0,0,0,0,1,0,1,1
Fiji,FJ,East Asia & Pacific,2021-08-27,passenger,84,0,170,170,254,468205.13960145036,3,0,1,1,4
Fiji,FJ,East Asia & Pacific,2021-08-28,cargo,0,0,0,0,0,0,0,0,1,1,1
Fiji,FJ,East Asia & Pacific,2021-08-28,passenger,92,0,313,313,405,672725.0404027223,1,0,1,1,2
Fiji,FJ,East Asia & Pacific,2021-08-29,cargo,0,0,0,0,0,0,0,1,0,1,1
Fiji,FJ,East Asia & Pacific,2021-08-29,passenger,46,0,0,0,46,0,1,0,0,0,1
Fiji,FJ,East Asia & Pacific,2021-08-30,cargo,0,0,0,0,0,0,0,0,1,1,1
Fiji,FJ,East Asia & Pacific,2021-08-30,passenger,19,0,302,302,321,649082.9463310612,1,0,1,1,2
Fiji,FJ,East Asia & Pacific,2021-08-31,passenger,38,0,313,313,351,675549.9505879764,2,0,1,1,3
Fiji,FJ,East Asia & Pacific,2021-09-01,cargo,0,0,0,0,0,0,0,1,0,1,1
Fiji,FJ,East Asia & Pacific,2021-09-01,passenger,38,0,0,0,38,4654.072265907837,2,0,0,0,2
Fiji,FJ,East Asia & Pacific,2021-09-02,cargo,0,0,0,0,0,0,0,0,1,1,1
Fiji,FJ,East Asia & Pacific,2021-09-02,passenger,19,0,756,756,775,3322312.2929555667,1,0,3,3,4
Fiji,FJ,East Asia & Pacific,2021-09-03,passenger,111,0,340,340,451,627995.4458953466,2,0,2,2,4
Fiji,FJ,East Asia & Pacific,2021-09-04,cargo,0,0,0,0,0,0,0,1,0,1,1
Fiji,FJ,East Asia & Pacific,2021-09-04,passenger,46,0,586,586,632,1538084.404628992,1,0,2,2,3
Fiji,FJ,East Asia & Pacific,2021-09-05,passenger,138,0,0,0,138,0,1,0,0,0,1
Fiji,FJ,East Asia & Pacific,2021-09-06,cargo,0,0,0,0,0,0,0,1,0,1,1
Fiji,FJ,East Asia & Pacific,2021-09-06,passenger,0,0,888,888,888,2227988.6806293903,0,0,2,2,2
Fiji,FJ,East Asia & Pacific,2021-09-07,passenger,111,0,586,586,697,1540411.440761946,2,0,2,2,4
Fiji,FJ,East Asia & Pacific,2021-09-08,passenger,149,0,313,313,462,2571071.8658625833,1,0,1,1,2
Fiji,FJ,East Asia & Pacific,2021-09-09,cargo,0,0,0,0,0,0,0,1,0,1,1
Fiji,FJ,East Asia & Pacific,2021-09-09,passenger,230,0,483,483,713,1028551.0778885069,1,0,2,2,3
Fiji,FJ,East Asia & Pacific,2021-09-10,cargo,0,0,0,0,0,0,0,1,0,1,1
Fiji,FJ,East Asia & Pacific,2021-09-10,passenger,65,0,756,756,821,3899940.038124262,2,0,3,3,5
Fiji,FJ,East Asia & Pacific,2021-09-11,passenger,46,0,586,586,632,1538084.404628992,1,0,2,2,3
Fiji,FJ,East Asia & Pacific,2021-09-12,cargo,0,0,0,0,0,0,0,2,0,2,2
Fiji,FJ,East Asia & Pacific,2021-09-12,passenger,92,0,165,165,257,354631.41107491753,1,0,1,1,2
Fiji,FJ,East Asia & Pacific,2021-09-13,passenger,84,0,588,588,672,1583204.2968568131,1,0,2,2,3
Fiji,FJ,East Asia & Pacific,2021-09-14,passenger,114,0,586,586,700,1546412.7444732483,2,0,2,2,4
Fiji,FJ,East Asia & Pacific,2021-09-15,cargo,0,0,0,0,0,0,0,1,0,1,1
Fiji,FJ,East Asia & Pacific,2021-09-15,passenger,46,0,0,0,46,0,1,0,0,0,1
Fiji,FJ,East Asia & Pacific,2021-09-16,cargo,0,0,0,0,0,0,0,0,1,1,1
Fiji,FJ,East Asia & Pacific,2021-09-16,passenger,0,0,483,483,483,2926897.903348368,0,0,2,2,2
Fiji,FJ,East Asia & Pacific,2021-09-17,cargo,0,0,0,0,0,0,0,1,0,1,1
Fiji,FJ,East Asia & Pacific,2021-09-17,passenger,92,0,170,170,262,472449.5258093894,2,0,1,1,3
Fiji,FJ,East Asia & Pacific,2021-09-18,passenger,138,0,586,586,724,1554986.0354893943,2,0,2,2,4
Fiji,FJ,East Asia & Pacific,2021-09-19,cargo,0,0,0,0,0,0,0,1,0,1,1
Fiji,FJ,East Asia & Pacific,2021-09-19,passenger,38,0,0,0,38,5998.620843203687,2,0,0,0,2
Fiji,FJ,East Asia & Pacific,2021-09-20,cargo,0,0,0,0,0,0,0,0,1,1,1
Fiji,FJ,East Asia & Pacific,2021-09-20,passenger,57,0,445,445,502,760193.0619173751,2,0,2,2,4
Fiji,FJ,East Asia & Pacific,2021-09-21,cargo,0,0,0,0,0,0,1,0,0,0,1
Fiji,FJ,East Asia & Pacific,2021-09-21,passenger,149,0,586,586,735,1557677.8155120844,3,0,2,2,5
Fiji,FJ,East Asia & Pacific,2021-09-22,passenger,141,0,313,313,454,2583428.9761132887,4,0,1,1,5
Fiji,FJ,East Asia & Pacific,2021-09-23,cargo,0,0,0,0,0,0,0,1,0,1,1
Fiji,FJ,East Asia & Pacific,2021-09-23,passenger,184,0,756,756,940,1909832.2682876196,4,0,3,3,7
Fiji,FJ,East Asia & Pacific,2021-09-24,cargo,0,0,0,0,0,0,0,1,0,1,1
Fiji,FJ,East Asia & Pacific,2021-09-24,passenger,222,0,483,483,705,3062733.658257584,4,0,2,2,6
Fiji,FJ,East Asia & Pacific,2021-09-25,cargo,0,0,0,0,0,0,0,0,1,1,1
Fiji,FJ,East Asia & Pacific,2021-09-25,passenger,76,0,586,586,662,1268786.9741675835,2,0,1,1,3
Fiji,FJ,East Asia & Pacific,2021-09-26,cargo,0,0,0,0,0,0,0,1,0,1,1
Fiji,FJ,East Asia & Pacific,2021-09-26,passenger,184,0,0,0,184,22535.507813869528,2,0,0,0,2
Fiji,FJ,East Asia & Pacific,2021-09-27,cargo,0,0,0,0,0,0,1,0,1,1,2
Fiji,FJ,East Asia & Pacific,2021-09-27,passenger,149,0,302,302,451,667331.8086368578,2,0,1,1,3
Fiji,FJ,East Asia & Pacific,2021-09-28,passenger,152,0,586,586,738,1559389.7908472153,3,0,2,2,5
Fiji,FJ,East Asia & Pacific,2021-09-29,passenger,130,0,0,0,130,15921.826172842602,2,0,0,0,2
Fiji,FJ,East Asia & Pacific,2021-09-30,cargo,0,0,0,0,0,0,0,1,0,1,1
Fiji,FJ,East Asia & Pacific,2021-09-30,passenger,203,0,756,756,959,1923743.0919439385,3,0,3,3,6
Fiji,FJ,East Asia & Pacific,2021-10-01,cargo,0,0,0,0,0,0,0,1,1,2,2
Fiji,FJ,East Asia & Pacific,2021-10-01,passenger,203,0,170,170,373,487388.864426574,3,0,1,1,4
Fiji,FJ,East Asia & Pacific,2021-10-02,passenger,184,0,586,586,770,1560619.9124428616,2,0,2,2,4
Fiji,FJ,East Asia & Pacific,2021-10-03,cargo,0,0,0,0,0,0,0,1,1,2,2
Fiji,FJ,East Asia & Pacific,2021-10-03,passenger,184,0,0,0,184,22535.507813869528,2,0,0,0,2
Fiji,FJ,East Asia & Pacific,2021-10-04,cargo,0,0,0,0,0,0,1,1,1,2,3
Fiji,FJ,East Asia & Pacific,2021-10-04,passenger,184,0,575,575,759,1258372.2433779761,2,0,1,1,3
Fiji,FJ,East Asia & Pacific,2021-10-05,passenger,247,0,313,313,560,704321.0587084192,3,0,1,1,4
Fiji,FJ,East Asia & Pacific,2021-10-06,passenger,184,0,443,443,627,1047940.7475612331,2,0,2,2,4
Fiji,FJ,East Asia & Pacific,2021-10-07,cargo,0,0,0,0,0,0,0,1,1,2,2
Fiji,FJ,East Asia & Pacific,2021-10-07,passenger,222,0,586,586,808,3466309.9073232226,3,0,2,2,5
Fiji,FJ,East Asia & Pacific,2021-10-08,cargo,0,0,0,0,0,0,0,0,1,1,1
Fiji,FJ,East Asia & Pacific,2021-10-08,passenger,203,0,170,170,373,487388.864426574,3,0,1,1,4
Fiji,FJ,East Asia & Pacific,2021-10-09,cargo,0,0,0,0,0,0,0,0,2,2,2
Fiji,FJ,East Asia & Pacific,2021-10-09,passenger,184,313,273,586,770,3667753.8596913866,2,1,1,2,4
Fiji,FJ,East Asia & Pacific,2021-10-10,cargo,0,0,0,0,0,0,0,1,0,1,1
Fiji,FJ,East Asia & Pacific,2021-10-10,passenger,222,0,302,302,524,676272.5264108386,2,0,1,1,3
Fiji,FJ,East Asia & Pacific,2021-10-11,cargo,0,0,0,0,0,0,0,1,2,3,3
Fiji,FJ,East Asia & Pacific,2021-10-11,passenger,184,0,0,0,184,22535.507813869528,2,0,0,0,2
Fiji,FJ,East Asia & Pacific,2021-10-12,cargo,0,0,0,0,0,0,0,0,1,1,1
Fiji,FJ,East Asia & Pacific,2021-10-12,passenger,266,0,273,273,539,900004.348250857,4,0,1,1,5
Fiji,FJ,East Asia & Pacific,2021-10-13,passenger,404,0,313,313,717,1043488.4552638286,6,0,1,1,7
Fiji,FJ,East Asia & Pacific,2021-10-14,cargo,0,0,0,0,0,0,0,1,0,1,1
Fiji,FJ,East Asia & Pacific,2021-10-14,passenger,535,0,586,586,1121,1610635.7444320102,8,0,2,2,10
Fiji,FJ,East Asia & Pacific,2021-10-15,cargo,0,0,0,0,0,0,0,0,1,1,1
Fiji,FJ,East Asia & Pacific,2021-10-15,passenger,402,0,170,170,572,523308.76584730804,5,0,1,1,6
Fiji,FJ,East Asia & Pacific,2021-10-16,cargo,0,0,0,0,0,0,0,0,2,2,2
Fiji,FJ,East Asia & Pacific,2021-10-16,passenger,241,313,540,853,1094,5776564.711575007,4,1,2,3,7
Fiji,FJ,East Asia & Pacific,2021-10-17,cargo,0,0,0,0,0,0,0,1,0,1,1
Fiji,FJ,East Asia & Pacific,2021-10-17,passenger,320,0,0,0,320,39293.69055429777,6,0,0,0,6
Fiji,FJ,East Asia & Pacific,2021-10-18,cargo,0,0,0,0,0,0,0,1,2,3,3
Fiji,FJ,East Asia & Pacific,2021-10-18,passenger,413,0,445,445,858,999220.9679907216,7,0,1,1,8
Fiji,FJ,East Asia & Pacific,2021-10-19,cargo,0,0,0,0,0,0,0,0,1,1,1
Fiji,FJ,East Asia & Pacific,2021-10-19,passenger,266,273,551,824,1090,3564935.1156096524,4,1,2,3,7
Fiji,FJ,East Asia & Pacific,2021-10-20,passenger,329,0,0,0,329,40656.52879752406,5,0,0,0,5
Fiji,FJ,East Asia & Pacific,2021-10-21,cargo,0,0,0,0,0,0,0,1,1,2,2
Fiji,FJ,East Asia & Pacific,2021-10-21,passenger,429,0,586,586,1015,3496734.4119954472,8,0,2,2,10
Fiji,FJ,East Asia & Pacific,2021-10-22,cargo,0,0,0,0,0,0,0,0,1,1,1
Fiji,FJ,East Asia & Pacific,2021-10-22,passenger,557,0,340,340,897,1011753.8421787875,5,0,1,1,6
Fiji,FJ,East Asia & Pacific,2021-10-23,cargo,0,0,0,0,0,0,0,0,2,2,2
Fiji,FJ,East Asia & Pacific,2021-10-23,passenger,266,313,443,756,1022,5426265.909701443,3,1,2,3,6
Fiji,FJ,East Asia & Pacific,2021-10-24,cargo,0,0,0,0,0,0,0,1,0,1,1
Fiji,FJ,East Asia & Pacific,2021-10-24,passenger,260,0,0,0,260,35976.60867214944,5,0,0,0,5
Fiji,FJ,East Asia & Pacific,2021-10-25,cargo,0,0,0,0,0,0,1,1,1,2,3
Fiji,FJ,East Asia & Pacific,2021-10-25,passenger,304,0,548,548,852,1217323.902806311,6,0,1,1,7
Fiji,FJ,East Asia & Pacific,2021-10-26,cargo,0,0,0,0,0,0,0,0,1,1,1
Fiji,FJ,East Asia & Pacific,2021-10-26,passenger,443,0,273,273,716,923027.0755404077,4,0,1,1,5
Fiji,FJ,East Asia & Pacific,2021-10-27,passenger,309,0,443,443,752,1070340.8856874052,5,0,2,2,7
Fiji,FJ,East Asia & Pacific,2021-10-28,cargo,0,0,0,0,0,0,0,1,1,2,2
Fiji,FJ,East Asia & Pacific,2021-10-28,passenger,440,0,579,579,1019,1458323.8012636753,6,0,3,3,9
Fiji,FJ,East Asia & Pacific,2021-10-29,cargo,0,0,0,0,0,0,0,0,1,1,1
Fiji,FJ,East Asia & Pacific,2021-10-29,passenger,619,0,170,170,789,555838.5204719654,6,0,1,1,7
Fiji,FJ,East Asia & Pacific,2021-10-30,cargo,0,0,0,0,0,0,0,1,2,3,3
Fiji,FJ,East Asia & Pacific,2021-10-30,passenger,285,0,417,417,702,932689.0531060499,4,0,2,2,6
Fiji,FJ,East Asia & Pacific,2021-10-31,cargo,0,0,0,0,0,0,0,1,0,1,1
Fiji,FJ,East Asia & Pacific,2021-10-31,passenger,358,0,0,0,358,51865.29040612648,6,0,0,0,6
Fiji,FJ,East Asia & Pacific,2021-11-01,cargo,0,0,0,0,0,0,0,1,2,3,3
Fiji,FJ,East Asia & Pacific,2021-11-01,passenger,334,273,302,575,909,3122096.4006871744,4,1,1,2,6
Fiji,FJ,East Asia & Pacific,2021-11-02,cargo,0,0,0,0,0,0,0,0,1,1,1
Fiji,FJ,East Asia & Pacific,2021-11-02,passenger,334,0,273,273,607,910965.2919751012,5,0,1,1,6
Fiji,FJ,East Asia & Pacific,2021-11-03,cargo,0,0,0,0,0,0,0,0,1,1,1
Fiji,FJ,East Asia & Pacific,2021-11-03,passenger,290,0,0,0,290,42040.81400551308,5,0,0,0,5
Fiji,FJ,East Asia & Pacific,2021-11-04,cargo,0,0,0,0,0,0,0,1,2,3,3
Fiji,FJ,East Asia & Pacific,2021-11-04,passenger,353,0,443,443,796,2457099.4478614633,5,0,2,2,7
Fiji,FJ,East Asia & Pacific,2021-11-05,passenger,334,0,350,350,684,1294866.4045862735,4,0,2,2,6
Fiji,FJ,East Asia & Pacific,2021-11-06,cargo,0,0,0,0,0,0,0,1,2,3,3
Fiji,FJ,East Asia & Pacific,2021-11-06,passenger,339,0,273,273,612,917847.2736237559,4,0,1,1,5
Fiji,FJ,East Asia & Pacific,2021-11-07,cargo,0,0,0,0,0,0,0,1,0,1,1
Fiji,FJ,East Asia & Pacific,2021-11-07,passenger,331,0,0,0,331,49902.99816290886,6,0,0,0,6
Fiji,FJ,East Asia & Pacific,2021-11-08,cargo,0,0,0,0,0,0,0,1,1,2,2
Fiji,FJ,East Asia & Pacific,2021-11-08,passenger,364,0,548,548,912,1232011.3914933885,4,0,1,1,5
Fiji,FJ,East Asia & Pacific,2021-11-09,cargo,0,0,0,0,0,0,0,0,1,1,1
Fiji,FJ,East Asia & Pacific,2021-11-09,passenger,383,0,273,273,656,921056.7346928944,5,0,1,1,6
Fiji,FJ,East Asia & Pacific,2021-11-10,cargo,0,0,0,0,0,0,0,1,1,2,2
Fiji,FJ,East Asia & Pacific,2021-11-10,passenger,339,0,170,170,509,827637.4833552359,5,0,1,1,6
Fiji,FJ,East Asia & Pacific,2021-11-11,cargo,0,0,0,0,0,0,0,1,2,3,3
Fiji,FJ,East Asia & Pacific,2021-11-11,passenger,421,0,273,273,694,2304004.7563607944,7,0,1,1,8
Fiji,FJ,East Asia & Pacific,2021-11-12,cargo,0,0,0,0,0,0,0,1,1,2,2
Fiji,FJ,East Asia & Pacific,2021-11-12,passenger,397,0,170,170,567,516539.7707478602,4,0,1,1,5
Fiji,FJ,East Asia & Pacific,2021-11-13,cargo,0,0,0,0,0,0,0,0,3,3,3
Fiji,FJ,East Asia & Pacific,2021-11-13,passenger,475,0,0,0,475,78146.10727949324,5,0,0,0,5
Fiji,FJ,East Asia & Pacific,2021-11-14,cargo,0,0,0,0,0,0,0,1,0,1,1
Fiji,FJ,East Asia & Pacific,2021-11-14,passenger,630,0,0,0,630,108677.0829186498,6,0,0,0,6
Fiji,FJ,East Asia & Pacific,2021-11-15,cargo,0,0,0,0,0,0,0,1,1,2,2
Fiji,FJ,East Asia & Pacific,2021-11-15,passenger,614,0,575,575,1189,1336762.3358276503,7,0,1,1,8
Fiji,FJ,East Asia & Pacific,2021-11-16,cargo,0,0,0,0,0,0,0,0,1,1,1
Fiji,FJ,East Asia & Pacific,2021-11-16,passenger,581,0,443,443,1024,847336.0030659086,7,0,2,2,9
Fiji,FJ,East Asia & Pacific,2021-11-17,cargo,0,0,0,0,0,0,0,1,0,1,1
Fiji,FJ,East Asia & Pacific,2021-11-17,passenger,537,0,273,273,810,676481.159535986,7,0,1,1,8
Fiji,FJ,East Asia & Pacific,2021-11-18,cargo,0,0,0,0,0,0,0,1,2,3,3
Fiji,FJ,East Asia & Pacific,2021-11-18,passenger,644,0,273,273,917,968560.2784361101,8,0,1,1,9
Fiji,FJ,East Asia & Pacific,2021-11-19,cargo,0,0,0,0,0,0,0,1,0,1,1
Fiji,FJ,East Asia & Pacific,2021-11-19,passenger,804,0,170,170,974,608128.7740860482,8,0,1,1,9
Fiji,FJ,East Asia & Pacific,2021-11-20,cargo,0,0,0,0,0,0,0,1,2,3,3
Fiji,FJ,East Asia & Pacific,2021-11-20,passenger,747,0,273,273,1020,2391388.0123078395,7,0,1,1,8
Fiji,FJ,East Asia & Pacific,2021-11-21,cargo,0,0,0,0,0,0,0,1,1,2,2
Fiji,FJ,East Asia & Pacific,2021-11-21,passenger,829,0,0,0,829,150730.82141815327,9,0,0,0,9
Fiji,FJ,East Asia & Pacific,2021-11-22,cargo,0,0,0,0,0,0,0,1,1,2,2
Fiji,FJ,East Asia & Pacific,2021-11-22,passenger,841,0,548,548,1389,1307550.1861455482,9,0,1,1,10
Fiji,FJ,East Asia & Pacific,2021-11-23,cargo,0,0,0,0,0,0,0,0,2,2,2
Fiji,FJ,East Asia & Pacific,2021-11-23,passenger,600,273,0,273,873,2495373.274004578,7,1,0,1,8
Fiji,FJ,East Asia & Pacific,2021-11-24,cargo,0,0,0,0,0,0,0,1,1,2,2
Fiji,FJ,East Asia & Pacific,2021-11-24,passenger,581,0,344,344,925,812186.9951116935,7,0,2,2,9
Fiji,FJ,East Asia & Pacific,2021-11-25,cargo,0,0,0,0,0,0,0,1,2,3,3
Fiji,FJ,East Asia & Pacific,2021-11-25,passenger,652,0,443,443,1095,1152861.0960433346,7,0,2,2,9
Fiji,FJ,East Asia & Pacific,2021-11-26,cargo,0,0,0,0,0,0,0,1,0,1,1
Fiji,FJ,East Asia & Pacific,2021-11-26,passenger,937,0,238,238,1175,713937.3709027306,9,0,2,2,11
Fiji,FJ,East Asia & Pacific,2021-11-27,cargo,0,0,0,0,0,0,0,0,3,3,3
Fiji,FJ,East Asia & Pacific,2021-11-27,passenger,630,0,273,273,903,972835.2540980201,5,0,1,1,6
Fiji,FJ,East Asia & Pacific,2021-11-28,cargo,0,0,0,0,0,0,0,1,0,1,1
Fiji,FJ,East Asia & Pacific,2021-11-28,passenger,897,0,0,0,897,168620.64354217594,10,0,0,0,10
Fiji,FJ,East Asia & Pacific,2021-11-29,cargo,0,0,0,0,0,0,0,1,1,2,2
Fiji,FJ,East Asia & Pacific,2021-11-29,passenger,852,0,575,575,1427,1355070.4759678633,11,0,1,1,12
Fiji,FJ,East Asia & Pacific,2021-11-30,cargo,0,0,0,0,0,0,0,0,1,1,1
Fiji,FJ,East Asia & Pacific,2021-11-30,passenger,979,0,443,443,1422,862485.4511820138,7,0,2,2,9
Fiji,FJ,East Asia & Pacific,2021-12-01,cargo,0,0,0,0,0,0,0,1,2,3,3
Fiji,FJ,East Asia & Pacific,2021-12-01,passenger,864,0,170,170,1034,607211.9999286904,9,0,1,1,10
Fiji,FJ,East Asia & Pacific,2021-12-02,cargo,0,0,0,0,0,0,0,1,2,3,3
Fiji,FJ,East Asia & Pacific,2021-12-02,passenger,962,0,783,783,1745,2146224.852038129,10,0,4,4,14
Fiji,FJ,East Asia & Pacific,2021-12-03,cargo,0,0,0,0,0,0,0,0,1,1,1
Fiji,FJ,East Asia & Pacific,2021-12-03,passenger,1090,273,680,953,2043,4407365.5178151755,10,1,4,5,15
Fiji,FJ,East Asia & Pacific,2021-12-04,cargo,0,0,0,0,0,0,0,1,2,3,3
Fiji,FJ,East Asia & Pacific,2021-12-04,passenger,916,0,653,653,1569,3951188.7105663894,9,0,3,3,12
Fiji,FJ,East Asia & Pacific,2021-12-05,cargo,0,0,0,0,0,0,0,2,1,3,3
Fiji,FJ,East Asia & Pacific,2021-12-05,passenger,970,0,783,783,1753,4071057.8633726244,9,0,4,4,13
Fiji,FJ,East Asia & Pacific,2021-12-06,cargo,0,0,0,0,0,0,0,0,2,2,2
Fiji,FJ,East Asia & Pacific,2021-12-06,passenger,837,483,915,1398,2235,6216642.007121979,11,2,3,5,16
Fiji,FJ,East Asia & Pacific,2021-12-07,cargo,0,0,0,0,0,0,0,1,1,2,2
Fiji,FJ,East Asia & Pacific,2021-12-07,passenger,1072,0,926,926,1998,2896598.7848976105,12,0,3,3,15
Fiji,FJ,East Asia & Pacific,2021-12-08,cargo,0,0,0,0,0,0,0,0,2,2,2
Fiji,FJ,East Asia & Pacific,2021-12-08,passenger,731,586,510,1096,1827,6949866.46994891,9,2,3,5,14
Fiji,FJ,East Asia & Pacific,2021-12-09,cargo,0,0,0,0,0,0,0,1,1,2,2
Fiji,FJ,East Asia & Pacific,2021-12-09,passenger,1132,0,993,993,2125,2467765.183491794,10,0,5,5,15
Fiji,FJ,East Asia & Pacific,2021-12-10,cargo,0,0,0,0,0,0,0,1,1,2,2
Fiji,FJ,East Asia & Pacific,2021-12-10,passenger,1038,313,613,926,1964,6286958.58600964,10,1,3,4,14
Fiji,FJ,East Asia & Pacific,2021-12-11,cargo,0,0,0,0,0,0,0,1,1,2,2
Fiji,FJ,East Asia & Pacific,2021-12-11,passenger,804,0,827,827,1631,2551947.7825185293,9,0,3,3,12
Fiji,FJ,East Asia & Pacific,2021-12-12,cargo,0,0,0,0,0,0,0,1,2,3,3
Fiji,FJ,East Asia & Pacific,2021-12-12,passenger,1141,273,684,957,2098,4809257.088268105,11,1,3,4,15
Fiji,FJ,East Asia & Pacific,2021-12-13,cargo,0,0,0,0,0,0,0,1,1,2,2
Fiji,FJ,East Asia & Pacific,2021-12-13,passenger,970,170,1125,1295,2265,4036328.3194475565,14,1,4,5,19
Fiji,FJ,East Asia & Pacific,2021-12-14,cargo,0,0,0,0,0,0,0,1,1,2,2
Fiji,FJ,East Asia & Pacific,2021-12-14,passenger,1082,0,926,926,2008,4323805.327098508,12,0,4,4,16
Fiji,FJ,East Asia & Pacific,2021-12-15,cargo,0,0,0,0,0,0,0,1,0,1,1
Fiji,FJ,East Asia & Pacific,2021-12-15,passenger,975,273,1096,1369,2344,7159951.298221256,12,1,4,5,17
Fiji,FJ,East Asia & Pacific,2021-12-16,cargo,0,0,0,0,0,0,0,0,1,1,1
Fiji,FJ,East Asia & Pacific,2021-12-16,passenger,951,334,1129,1463,2414,6254002.94823752,11,1,4,5,16
Fiji,FJ,East Asia & Pacific,2021-12-17,cargo,0,0,0,0,0,0,0,1,0,1,1
Fiji,FJ,East Asia & Pacific,2021-12-17,passenger,1127,313,1319,1632,2759,8555115.16721519,13,1,4,5,18
Fiji,FJ,East Asia & Pacific,2021-12-18,cargo,0,0,0,0,0,0,0,0,1,1,1
Fiji,FJ,East Asia & Pacific,2021-12-18,passenger,1000,607,2229,2836,3836,12340215.646287445,9,2,4,6,15
Fiji,FJ,East Asia & Pacific,2021-12-19,cargo,0,0,0,0,0,0,0,1,0,1,1
Fiji,FJ,East Asia & Pacific,2021-12-19,passenger,1095,313,1463,1776,2871,9118178.029514639,9,1,4,5,14
Fiji,FJ,East Asia & Pacific,2021-12-20,passenger,986,777,1651,2428,3414,11137298.160679843,12,3,3,6,18
Fiji,FJ,East Asia & Pacific,2021-12-21,passenger,1204,334,1610,1944,3148,9485593.979623625,17,1,4,5,22
Fiji,FJ,East Asia & Pacific,2021-12-22,passenger,972,607,1772,2379,3351,12097727.061409526,12,2,5,7,19
Fiji,FJ,East Asia & Pacific,2021-12-23,passenger,1081,334,1849,2183,3264,8753817.623291768,13,1,4,5,18
Fiji,FJ,East Asia & Pacific,2021-12-24,passenger,1079,546,2169,2715,3794,13545438.759712728,10,2,4,6,16
Fiji,FJ,East Asia & Pacific,2021-12-25,passenger,989,334,1699,2033,3022,8452302.417215478,9,1,3,4,13
Fiji,FJ,East Asia & Pacific,2021-12-26,passenger,1065,607,1638,2245,3310,12160315.625343094,11,2,4,6,17
Fiji,FJ,East Asia & Pacific,2021-12-27,passenger,856,777,2513,3290,4146,14001081.523622701,9,3,4,7,16
Fiji,FJ,East Asia & Pacific,2021-12-28,passenger,783,334,2132,2466,3249,11106101.99252755,10,1,5,6,16
Fiji,FJ,East Asia & Pacific,2021-12-29,passenger,994,334,1995,2329,3323,10826634.268261986,13,1,4,5,18
Fiji,FJ,East Asia & Pacific,2021-12-30,passenger,1076,334,993,1327,2403,6108395.283662434,10,1,3,4,14
Fiji,FJ,East Asia & Pacific,2021-12-31,passenger,1144,607,1204,1811,2955,9518330.527097829,13,2,2,4,17
Fiji,FJ,East Asia & Pacific,2022-01-01,passenger,1038,607,1699,2306,3344,10850098.689880997,8,2,3,5,13
Fiji,FJ,East Asia & Pacific,2022-01-02,passenger,1046,313,2163,2476,3522,11450879.60459949,12,1,4,5,17
Fiji,FJ,East Asia & Pacific,2022-01-03,passenger,693,1111,1971,3082,3775,15115633.320608446,8,3,4,7,15
Fiji,FJ,East Asia & Pacific,2022-01-04,passenger,949,334,1677,2011,2960,8361642.976792807,10,1,3,4,14
Fiji,FJ,East Asia & Pacific,2022-01-05,passenger,823,607,1907,2514,3337,12909784.86428789,9,2,4,6,15
Fiji,FJ,East Asia & Pacific,2022-01-06,passenger,978,334,1536,1870,2848,8520198.264813306,10,1,2,3,13
Fiji,FJ,East Asia & Pacific,2022-01-07,passenger,1106,334,1210,1544,2650,7122243.554602645,11,1,2,3,14
Fiji,FJ,East Asia & Pacific,2022-01-08,passenger,823,607,1863,2470,3293,11455196.199078457,10,2,3,5,15
Fiji,FJ,East Asia & Pacific,2022-01-09,passenger,179,647,1200,1847,2026,9711562.255419098,4,2,3,5,9
Fiji,FJ,East Asia & Pacific,2022-01-10,passenger,851,504,1869,2373,3224,9821855.388436656,7,2,3,5,12
Fiji,FJ,East Asia & Pacific,2022-01-11,passenger,870,334,2252,2586,3456,11066372.223618042,9,1,5,6,15
Fiji,FJ,East Asia & Pacific,2022-01-12,passenger,739,607,1588,2195,2934,11473918.2222377,9,2,5,7,16
Fiji,FJ,East Asia & Pacific,2022-01-13,passenger,861,334,850,1184,2045,5962266.831677741,9,1,2,3,12
Fiji,FJ,East Asia & Pacific,2022-01-14,passenger,644,607,1726,2333,2977,10930051.782268405,7,2,4,6,13
Fiji,FJ,East Asia & Pacific,2022-01-15,passenger,470,334,1863,2197,2667,8860566.192176417,6,1,3,4,10
Fiji,FJ,East Asia & Pacific,2022-01-16,passenger,383,0,530,530,913,1737255.912304638,5,0,1,1,6
Fiji,FJ,East Asia & Pacific,2022-01-17,passenger,445,647,1469,2116,2561,10724777.877166703,7,2,3,5,12
Fiji,FJ,East Asia & Pacific,2022-01-18,passenger,860,334,1989,2323,3183,8799047.514025949,10,1,4,5,15
Fiji,FJ,East Asia & Pacific,2022-01-19,passenger,690,607,1551,2158,2848,10115999.44744027,7,2,5,7,14
Fiji,FJ,East Asia & Pacific,2022-01-20,passenger,804,334,1020,1354,2158,6107724.562544434,10,1,3,4,14
Fiji,FJ,East Asia & Pacific,2022-01-21,passenger,737,647,1817,2464,3201,13157719.834982084,8,2,4,6,14
Fiji,FJ,East Asia & Pacific,2022-01-22,passenger,693,334,1687,2021,2714,8221723.140034553,7,1,3,4,11
Fiji,FJ,East Asia & Pacific,2022-01-23,passenger,655,647,2070,2717,3372,12530995.126382617,5,2,3,5,10
Fiji,FJ,East Asia & Pacific,2022-01-24,passenger,644,504,1507,2011,2655,8427760.414208595,8,2,4,6,14
Fiji,FJ,East Asia & Pacific,2022-01-25,passenger,764,334,1090,1424,2188,7741705.333855308,8,1,4,5,13
Fiji,FJ,East Asia & Pacific,2022-01-26,passenger,731,607,1458,2065,2796,9823967.983813187,8,2,4,6,14
Fiji,FJ,East Asia & Pacific,2022-01-27,passenger,823,334,1131,1465,2288,6532470.842360216,11,1,3,4,15
Fiji,FJ,East Asia & Pacific,2022-01-28,passenger,794,607,1550,2157,2951,10560572.5580906,9,2,3,5,14
Fiji,FJ,East Asia & Pacific,2022-01-29,passenger,402,334,1523,1857,2259,7655962.948084574,5,1,3,4,9
Fiji,FJ,East Asia & Pacific,2022-01-30,passenger,106,647,1817,2464,2570,13031609.849670125,2,2,4,6,8
Fiji,FJ,East Asia & Pacific,2022-01-31,passenger,19,504,1337,1841,1860,7796896.401292348,1,2,4,6,7
Fiji,FJ,East Asia & Pacific,2022-02-01,passenger,171,334,1430,1764,1935,8655045.765186492,5,1,5,6,11
Fiji,FJ,East Asia & Pacific,2022-02-02,passenger,46,334,1209,1543,1589,7525476.021356547,1,1,4,5,6
Fiji,FJ,East Asia & Pacific,2022-02-03,passenger,182,334,1228,1562,1744,6444360.427176101,2,1,3,4,6
Fiji,FJ,East Asia & Pacific,2022-02-04,passenger,320,0,1009,1009,1329,3310657.245418496,6,0,3,3,9
Fiji,FJ,East Asia & Pacific,2022-02-05,passenger,301,607,1331,1938,2239,9440794.56219916,7,2,3,5,12
Fiji,FJ,East Asia & Pacific,2022-02-06,passenger,111,334,1018,1352,1463,6262689.955053376,3,1,3,4,7
Fiji,FJ,East Asia & Pacific,2022-02-07,passenger,179,273,817,1090,1269,4699290.699736036,3,1,2,3,6
Fiji,FJ,East Asia & Pacific,2022-02-08,passenger,57,334,1430,1764,1821,8758952.823513122,3,1,5,6,9
Fiji,FJ,East Asia & Pacific,2022-02-09,passenger,84,334,623,957,1041,4678376.129518819,3,1,2,3,6
Fiji,FJ,East Asia & Pacific,2022-02-10,passenger,114,334,806,1140,1254,5366804.432792691,2,1,3,4,6
Fiji,FJ,East Asia & Pacific,2022-02-11,passenger,111,334,1030,1364,1475,6294867.4574945085,3,1,3,4,7
Fiji,FJ,East Asia & Pacific,2022-02-12,passenger,65,607,1161,1768,1833,8860649.743913623,2,2,3,5,7
Fiji,FJ,East Asia & Pacific,2022-02-13,passenger,0,334,1018,1352,1352,6234089.551449338,0,1,3,4,4
Fiji,FJ,East Asia & Pacific,2022-02-14,passenger,125,777,926,1703,1828,8831152.942898894,3,3,3,6,9
Fiji,FJ,East Asia & Pacific,2022-02-15,passenger,125,334,1578,1912,2037,7315791.3355830945,4,1,6,7,11
Fiji,FJ,East Asia & Pacific,2022-02-16,passenger,450,334,669,1003,1453,4855203.971449305,11,1,2,3,14
Fiji,FJ,East Asia & Pacific,2022-02-17,passenger,65,334,779,1113,1178,5306305.770219477,2,1,3,4,6
Fiji,FJ,East Asia & Pacific,2022-02-18,passenger,182,334,1030,1364,1546,6300154.071286287,3,1,3,4,7
Fiji,FJ,East Asia & Pacific,2022-02-19,passenger,155,607,1161,1768,1923,8865936.357705403,3,2,3,5,8
Fiji,FJ,East Asia & Pacific,2022-02-20,passenger,155,334,1018,1352,1507,6250060.028133451,3,1,3,4,7
Fiji,FJ,East Asia & Pacific,2022-02-21,passenger,38,607,647,1254,1292,7105783.057656133,2,2,2,4,6
Fiji,FJ,East Asia & Pacific,2022-02-22,passenger,38,334,1260,1594,1632,8092152.880343155,2,1,5,6,8
Fiji,FJ,East Asia & Pacific,2022-02-23,passenger,0,334,766,1100,1100,5075018.117048377,0,1,2,3,3
Fiji,FJ,East Asia & Pacific,2022-02-24,passenger,133,334,779,1113,1246,5314634.110063733,3,1,3,4,7
Fiji,FJ,East Asia & Pacific,2022-02-25,passenger,239,334,1024,1358,1597,6289911.288100821,4,1,3,4,8
Fiji,FJ,East Asia & Pacific,2022-02-26,passenger,209,641,1161,1802,2011,9063460.168268342,5,3,3,6,11
Fiji,FJ,East Asia & Pacific,2022-02-27,passenger,225,334,1434,1768,1993,8993300.89644443,4,1,4,5,9
Fiji,FJ,East Asia & Pacific,2022-02-28,passenger,277,607,1117,1724,2001,8420977.823570762,5,2,4,6,11
Fiji,FJ,East Asia & Pacific,2022-03-01,passenger,481,334,1090,1424,1905,6290344.868900531,6,1,4,5,11
Fiji,FJ,East Asia & Pacific,2022-03-02,passenger,819,334,669,1003,1822,4915154.082927931,13,1,2,3,16
Fiji,FJ,East Asia & Pacific,2022-03-03,passenger,1336,334,504,838,2174,4934186.189947733,16,1,2,3,19
Fiji,FJ,East Asia & Pacific,2022-03-04,passenger,1079,334,1030,1364,2443,6466472.835202641,12,1,3,4,16
Fiji,FJ,East Asia & Pacific,2022-03-05,passenger,562,607,1736,2343,2905,10146708.568195079,10,2,4,6,16
Fiji,FJ,East Asia & Pacific,2022-03-06,passenger,456,334,1162,1496,1952,6701385.065693981,6,1,3,4,10
Fiji,FJ,East Asia & Pacific,2022-03-07,passenger,296,607,653,1260,1556,7160370.690412583,6,2,2,4,10
Fiji,FJ,East Asia & Pacific,2022-03-08,passenger,231,334,1330,1664,1895,8189817.541080258,5,1,6,7,12
Fiji,FJ,East Asia & Pacific,2022-03-09,passenger,456,334,916,1250,1706,5462355.876221374,4,1,3,4,8
Fiji,FJ,East Asia & Pacific,2022-03-10,passenger,684,334,1163,1497,2181,6200772.0253425175,7,1,4,5,12
Fiji,FJ,East Asia & Pacific,2022-03-11,passenger,508,334,1206,1540,2048,6914769.077101674,6,1,3,4,10
Fiji,FJ,East Asia & Pacific,2022-03-12,passenger,475,607,1566,2173,2648,9970552.64237217,6,2,3,5,11
Fiji,FJ,East Asia & Pacific,2022-03-13,passenger,225,334,1194,1528,1753,6826034.97343043,4,1,3,4,8
Fiji,FJ,East Asia & Pacific,2022-03-14,passenger,285,607,999,1606,1891,8371112.076392375,5,2,3,5,10
Fiji,FJ,East Asia & Pacific,2022-03-15,passenger,394,334,1157,1491,1885,6242358.160884622,4,1,5,6,10
Fiji,FJ,East Asia & Pacific,2022-03-16,passenger,353,334,635,969,1322,5029964.385786522,4,1,1,2,6
Fiji,FJ,East Asia & Pacific,2022-03-17,passenger,442,334,817,1151,1593,5464484.88582328,6,1,3,4,10
Fiji,FJ,East Asia & Pacific,2022-03-18,passenger,633,334,1546,1880,2513,7506171.945012849,8,1,5,6,14
Fiji,FJ,East Asia & Pacific,2022-03-19,passenger,361,607,1736,2343,2704,10325229.363201397,6,2,4,6,12
Fiji,FJ,East Asia & Pacific,2022-03-20,passenger,315,334,1430,1764,2079,7664660.070226282,4,1,5,6,10
Fiji,FJ,East Asia & Pacific,2022-03-21,passenger,285,607,659,1266,1551,7176071.276039823,4,2,2,4,8
Fiji,FJ,East Asia & Pacific,2022-03-22,passenger,369,334,1117,1451,1820,7741867.687842653,4,1,5,6,10
Fiji,FJ,East Asia & Pacific,2022-03-23,passenger,396,334,975,1309,1705,6038814.312128038,5,1,2,3,8
Fiji,FJ,East Asia & Pacific,2022-03-24,passenger,391,334,1533,1867,2258,8799998.183511682,7,1,4,5,12
Fiji,FJ,East Asia & Pacific,2022-03-25,passenger,774,334,1376,1710,2484,6857137.068399187,7,1,4,5,12
Fiji,FJ,East Asia & Pacific,2022-03-26,passenger,426,607,1539,2146,2572,9918558.533911288,7,2,3,5,12
Fiji,FJ,East Asia & Pacific,2022-03-27,passenger,570,334,1194,1528,2098,6889856.999259762,7,1,3,4,11
Fiji,FJ,East Asia & Pacific,2022-03-28,passenger,399,607,1015,1622,2021,8324223.651248036,5,2,2,4,9
Fiji,FJ,East Asia & Pacific,2022-03-29,passenger,522,334,1347,1681,2203,6939192.69107891,6,1,4,5,11
Fiji,FJ,East Asia & Pacific,2022-03-30,passenger,497,334,1139,1473,1970,6180133.3763526045,6,1,3,4,10
Fiji,FJ,East Asia & Pacific,2022-03-31,passenger,638,334,1337,1671,2309,7061570.642445453,7,1,4,5,12
Fiji,FJ,East Asia & Pacific,2022-04-01,cargo,0,0,0,0,0,0,0,0,1,1,1
Fiji,FJ,East Asia & Pacific,2022-04-01,passenger,565,334,1949,2283,2848,8692086.830641719,8,1,4,5,13
Fiji,FJ,East Asia & Pacific,2022-04-02,passenger,608,607,1614,2221,2829,10375684.852629181,8,2,4,6,14
Fiji,FJ,East Asia & Pacific,2022-04-03,passenger,524,647,1024,1671,2195,9095999.543213604,7,2,3,5,12
Fiji,FJ,East Asia & Pacific,2022-04-04,cargo,0,0,0,0,0,0,0,1,0,1,1
Fiji,FJ,East Asia & Pacific,2022-04-04,passenger,619,334,1991,2325,2944,8792573.558118775,6,1,4,5,11
Fiji,FJ,East Asia & Pacific,2022-04-05,passenger,367,334,1191,1525,1892,8105789.310003903,6,1,5,6,12
Fiji,FJ,East Asia & Pacific,2022-04-06,passenger,505,607,1169,1776,2281,9242690.579099474,8,2,4,6,14
Fiji,FJ,East Asia & Pacific,2022-04-07,passenger,662,334,1651,1985,2647,8029234.340338706,10,1,5,6,16
Fiji,FJ,East Asia & Pacific,2022-04-08,passenger,559,647,2033,2680,3239,12044118.562488697,8,2,4,6,14
Fiji,FJ,East Asia & Pacific,2022-04-09,passenger,665,334,2593,2927,3592,11011810.717492413,9,1,4,5,14
Fiji,FJ,East Asia & Pacific,2022-04-10,passenger,581,647,2102,2749,3330,12424947.377924629,8,2,4,6,14
Fiji,FJ,East Asia & Pacific,2022-04-11,passenger,570,504,2580,3084,3654,13125536.433051212,7,2,5,7,14
Fiji,FJ,East Asia & Pacific,2022-04-12,passenger,916,334,1647,1981,2897,9784171.53087903,11,1,4,5,16
Fiji,FJ,East Asia & Pacific,2022-04-13,passenger,619,607,1355,1962,2581,9840051.129865775,7,2,4,6,13
Fiji,FJ,East Asia & Pacific,2022-04-14,passenger,836,334,2132,2466,3302,9642034.288787495,9,1,5,6,15
Fiji,FJ,East Asia & Pacific,2022-04-15,passenger,763,647,2383,3030,3793,13184840.265209524,7,2,4,6,13
Fiji,FJ,East Asia & Pacific,2022-04-16,passenger,426,334,2696,3030,3456,11366577.525899524,8,1,5,6,14
Fiji,FJ,East Asia & Pacific,2022-04-17,passenger,845,647,2377,3024,3869,12979035.899268426,9,2,5,7,16
Fiji,FJ,East Asia & Pacific,2022-04-18,passenger,475,504,2337,2841,3316,10982153.124500174,7,2,4,6,13
Fiji,FJ,East Asia & Pacific,2022-04-19,passenger,745,334,1966,2300,3045,10448188.994565377,6,1,5,6,12
Fiji,FJ,East Asia & Pacific,2022-04-20,passenger,491,607,1701,2308,2799,10742260.151868777,7,2,5,7,14
Fiji,FJ,East Asia & Pacific,2022-04-21,passenger,662,334,1859,2193,2855,8292093.130752894,9,1,6,7,16
Fiji,FJ,East Asia & Pacific,2022-04-22,passenger,611,647,2824,3471,4082,15607332.961102324,8,2,6,8,16
Fiji,FJ,East Asia & Pacific,2022-04-23,passenger,665,334,2866,3200,3865,11930828.45774882,9,1,5,6,15
Fiji,FJ,East Asia & Pacific,2022-04-24,passenger,605,647,2648,3295,3900,13916086.777900588,7,2,6,8,15
Fiji,FJ,East Asia & Pacific,2022-04-25,passenger,524,504,2167,2671,3195,10314384.19220321,7,2,4,6,13
Fiji,FJ,East Asia & Pacific,2022-04-26,passenger,603,334,1604,1938,2541,9282996.543038748,7,1,5,6,13
Fiji,FJ,East Asia & Pacific,2022-04-27,passenger,456,607,1339,1946,2402,9472704.887472128,6,2,5,7,13
Fiji,FJ,East Asia & Pacific,2022-04-28,passenger,747,334,1327,1661,2408,7011916.831853855,10,1,5,6,16
Fiji,FJ,East Asia & Pacific,2022-04-29,passenger,768,607,2243,2850,3618,13590220.158560755,8,2,5,7,15
Fiji,FJ,East Asia & Pacific,2022-04-30,passenger,592,334,2230,2564,3156,9198307.089308113,7,1,7,8,15
Fiji,FJ,East Asia & Pacific,2022-05-01,passenger,608,647,2472,3119,3727,13160343.210783854,8,2,6,8,16
Fiji,FJ,East Asia & Pacific,2022-05-02,passenger,590,504,1595,2099,2689,8444216.437272845,7,2,4,6,13
Fiji,FJ,East Asia & Pacific,2022-05-03,passenger,659,334,1948,2282,2941,10146042.10945196,8,1,6,7,15
Fiji,FJ,East Asia & Pacific,2022-05-04,passenger,320,607,1836,2443,2763,10697382.700703224,7,2,5,7,14
Fiji,FJ,East Asia & Pacific,2022-05-05,passenger,545,334,1331,1665,2210,6871662.877877323,9,1,4,5,14
Fiji,FJ,East Asia & Pacific,2022-05-06,passenger,589,647,2243,2890,3479,13919156.357489435,8,2,5,7,15
Fiji,FJ,East Asia & Pacific,2022-05-07,passenger,589,334,2354,2688,3277,9620353.06580269,8,1,6,7,15
Fiji,FJ,East Asia & Pacific,2022-05-08,passenger,448,920,2302,3222,3670,14996896.869554497,8,2,6,8,16
Fiji,FJ,East Asia & Pacific,2022-05-09,passenger,445,504,1935,2439,2884,9322481.170868836,7,2,5,7,14
Fiji,FJ,East Asia & Pacific,2022-05-10,passenger,636,334,1778,2112,2748,9607844.517429825,8,1,6,7,15
Fiji,FJ,East Asia & Pacific,2022-05-11,passenger,586,607,1807,2414,3000,10603663.507396976,8,2,6,8,16
Fiji,FJ,East Asia & Pacific,2022-05-12,passenger,638,334,1501,1835,2473,7025516.718809344,10,1,5,6,16
Fiji,FJ,East Asia & Pacific,2022-05-13,passenger,453,607,2237,2844,3297,13537892.93767596,7,2,5,7,14
Fiji,FJ,East Asia & Pacific,2022-05-14,passenger,586,334,2252,2586,3172,9314624.520677228,8,1,6,7,15
Fiji,FJ,East Asia & Pacific,2022-05-15,passenger,478,607,2140,2747,3225,11752942.39059667,8,2,5,7,15
Fiji,FJ,East Asia & Pacific,2022-05-16,passenger,456,504,1635,2139,2595,8498351.053889407,6,2,4,6,12
Fiji,FJ,East Asia & Pacific,2022-05-17,passenger,747,334,1948,2282,3029,10200516.110567654,11,1,6,7,18
Fiji,FJ,East Asia & Pacific,2022-05-18,passenger,521,607,1739,2346,2867,10526709.680197328,7,2,5,7,14
Fiji,FJ,East Asia & Pacific,2022-05-19,passenger,502,334,1371,1705,2207,6923264.131398104,8,1,4,5,13
Fiji,FJ,East Asia & Pacific,2022-05-20,passenger,640,607,2243,2850,3490,13602549.378518214,11,2,5,7,18
Fiji,FJ,East Asia & Pacific,2022-05-21,passenger,491,334,2394,2728,3219,9702157.571670482,8,1,6,7,15
Fiji,FJ,East Asia & Pacific,2022-05-22,passenger,589,334,2302,2636,3225,9939887.912428638,8,1,6,7,15
Fiji,FJ,East Asia & Pacific,2022-05-23,passenger,546,817,1929,2746,3292,12242703.661546156,7,3,4,7,14
Fiji,FJ,East Asia & Pacific,2022-05-24,passenger,628,334,1948,2282,2910,10154223.295329144,9,1,6,7,16
Fiji,FJ,East Asia & Pacific,2022-05-25,passenger,594,607,1739,2346,2940,10530118.187890105,7,2,5,7,14
Fiji,FJ,East Asia & Pacific,2022-05-26,passenger,507,334,1331,1665,2172,6856873.8117081085,9,1,4,5,14
Fiji,FJ,East Asia & Pacific,2022-05-27,passenger,597,647,2140,2787,3384,13517527.097901272,7,2,5,7,14
Fiji,FJ,East Asia & Pacific,2022-05-28,passenger,451,334,2320,2654,3105,9357427.743619744,7,1,7,8,15
Fiji,FJ,East Asia & Pacific,2022-05-29,passenger,600,817,2140,2957,3557,12998544.047238663,8,3,5,8,16
Fiji,FJ,East Asia & Pacific,2022-05-30,passenger,681,334,1778,2112,2793,8159617.420361653,7,1,4,5,12
Fiji,FJ,East Asia & Pacific,2022-05-31,passenger,568,334,1948,2282,2850,10139618.75004641,8,1,6,7,15
Fiji,FJ,East Asia & Pacific,2022-06-01,passenger,388,607,1745,2352,2740,10513844.904831493,7,2,5,7,14
Fiji,FJ,East Asia & Pacific,2022-06-02,passenger,542,334,1501,1835,2377,7407560.110266781,9,1,4,5,14
Fiji,FJ,East Asia & Pacific,2022-06-03,passenger,491,647,1903,2550,3041,11410739.007268764,8,2,4,6,14
Fiji,FJ,East Asia & Pacific,2022-06-04,passenger,445,334,2566,2900,3345,11893877.904749973,6,1,6,7,13
Fiji,FJ,East Asia & Pacific,2022-06-05,passenger,581,647,2140,2787,3368,12123279.197254999,6,2,5,7,13
Fiji,FJ,East Asia & Pacific,2022-06-06,passenger,412,504,2094,2598,3010,11365026.02623643,7,2,5,7,14
Fiji,FJ,East Asia & Pacific,2022-06-07,passenger,674,334,1438,1772,2446,7255867.133058442,8,1,4,5,13
Fiji,FJ,East Asia & Pacific,2022-06-08,passenger,486,607,1909,2516,3002,11372103.51660129,8,2,6,8,16
Fiji,FJ,East Asia & Pacific,2022-06-09,passenger,591,334,1569,1903,2494,7437362.699335938,10,1,6,7,17
Fiji,FJ,East Asia & Pacific,2022-06-10,passenger,540,981,2424,3405,3945,16966967.277776882,7,2,6,8,15
Fiji,FJ,East Asia & Pacific,2022-06-11,passenger,665,334,2422,2756,3421,11204156.016673278,7,1,7,8,15
Fiji,FJ,East Asia & Pacific,2022-06-12,passenger,510,647,2140,2787,3297,12122318.593999758,7,2,5,7,14
Fiji,FJ,East Asia & Pacific,2022-06-13,passenger,518,504,2537,3041,3559,12992968.176202904,8,2,7,9,17
Fiji,FJ,East Asia & Pacific,2022-06-14,passenger,497,334,2137,2471,2968,8696084.998735322,8,1,7,8,16
Fiji,FJ,East Asia & Pacific,2022-06-15,passenger,499,607,1909,2516,3015,11376442.992237197,7,2,6,8,15
Fiji,FJ,East Asia & Pacific,2022-06-16,passenger,717,334,1917,2251,2968,9249191.113055583,11,1,6,7,18
Fiji,FJ,East Asia & Pacific,2022-06-17,passenger,662,647,2310,2957,3619,12587192.754230723,7,2,4,6,13
Fiji,FJ,East Asia & Pacific,2022-06-18,passenger,494,607,2634,3241,3735,14643089.566798767,8,2,7,9,17
Fiji,FJ,East Asia & Pacific,2022-06-19,passenger,689,647,2140,2787,3476,12145006.594392454,10,2,5,7,17
Fiji,FJ,East Asia & Pacific,2022-06-20,passenger,448,504,2537,3041,3489,12671418.091565369,6,2,5,7,13
Fiji,FJ,East Asia & Pacific,2022-06-21,passenger,783,334,1505,1839,2622,7363954.634538963,9,1,5,6,15
Fiji,FJ,East Asia & Pacific,2022-06-22,passenger,578,607,1977,2584,3162,10973997.508780112,8,2,6,8,16
Fiji,FJ,East Asia & Pacific,2022-06-23,passenger,630,334,1814,2148,2778,8414636.519600648,10,1,5,6,16
Fiji,FJ,East Asia & Pacific,2022-06-24,passenger,518,647,3202,3849,4367,16387993.190949973,7,2,5,7,14
Fiji,FJ,East Asia & Pacific,2022-06-25,passenger,625,607,3114,3721,4346,15951340.854463885,8,2,7,9,17
Fiji,FJ,East Asia & Pacific,2022-06-26,passenger,885,647,3002,3649,4534,15185513.638828378,8,2,6,8,16
Fiji,FJ,East Asia & Pacific,2022-06-27,passenger,480,504,2862,3366,3846,13479618.252789434,9,2,7,9,18
Fiji,FJ,East Asia & Pacific,2022-06-28,cargo,0,0,0,0,0,0,0,1,0,1,1
Fiji,FJ,East Asia & Pacific,2022-06-28,passenger,522,334,2367,2701,3223,9965335.70866578,8,1,6,7,15
Fiji,FJ,East Asia & Pacific,2022-06-29,passenger,551,607,2188,2795,3346,11595033.321404567,9,2,5,7,16
Fiji,FJ,East Asia & Pacific,2022-06-30,passenger,814,334,2399,2733,3547,9800411.476003656,10,1,6,7,17
Fiji,FJ,East Asia & Pacific,2022-07-01,passenger,497,647,2656,3303,3800,13798544.983605659,7,2,4,6,13
Fiji,FJ,East Asia & Pacific,2022-07-02,passenger,869,607,3470,4077,4946,17118960.335309114,9,2,7,9,18
Fiji,FJ,East Asia & Pacific,2022-07-03,passenger,801,817,2985,3802,4603,15252898.884203773,9,3,6,9,18
Fiji,FJ,East Asia & Pacific,2022-07-04,passenger,649,334,3360,3694,4343,13990331.869526362,7,1,9,10,17
Fiji,FJ,East Asia & Pacific,2022-07-05,passenger,829,334,2553,2887,3716,10763296.31750344,8,1,5,6,14
Fiji,FJ,East Asia & Pacific,2022-07-06,passenger,782,607,2441,3048,3830,12269172.868284145,7,2,5,7,14
Fiji,FJ,East Asia & Pacific,2022-07-07,passenger,791,334,3092,3426,4217,12295784.66405106,8,1,7,8,16
Fiji,FJ,East Asia & Pacific,2022-07-08,passenger,649,647,3677,4324,4973,16205580.94464459,9,2,6,8,17
Fiji,FJ,East Asia & Pacific,2022-07-09,passenger,812,607,3527,4134,4946,16802364.420812733,8,2,9,11,19
Fiji,FJ,East Asia & Pacific,2022-07-10,passenger,785,817,3747,4564,5349,17409733.761641715,8,3,7,10,18
Fiji,FJ,East Asia & Pacific,2022-07-11,passenger,554,334,3470,3804,4358,13739746.067434521,7,1,11,12,19
Fiji,FJ,East Asia & Pacific,2022-07-12,passenger,690,334,2450,2784,3474,10340122.456953527,10,1,5,6,16
Fiji,FJ,East Asia & Pacific,2022-07-13,passenger,752,607,2742,3349,4101,12747747.81806668,10,2,7,9,19
Fiji,FJ,East Asia & Pacific,2022-07-14,passenger,924,334,3142,3476,4400,12201170.031384977,8,1,8,9,17
Fiji,FJ,East Asia & Pacific,2022-07-15,passenger,676,647,3123,3770,4446,14559339.894319177,9,2,7,9,18
Fiji,FJ,East Asia & Pacific,2022-07-16,passenger,809,607,3679,4286,5095,17675734.582894247,7,2,7,9,16
Fiji,FJ,East Asia & Pacific,2022-07-17,passenger,788,647,3026,3673,4461,14128637.366451724,8,2,7,9,17
Fiji,FJ,East Asia & Pacific,2022-07-18,passenger,647,504,3695,4199,4846,15287143.478350436,8,2,11,13,21
Fiji,FJ,East Asia & Pacific,2022-07-19,passenger,613,334,2348,2682,3295,9848600.932205617,9,1,6,7,16
Fiji,FJ,East Asia & Pacific,2022-07-20,passenger,833,607,2441,3048,3881,12268173.643407106,8,2,5,7,15
Fiji,FJ,East Asia & Pacific,2022-07-21,passenger,943,334,2898,3232,4175,11081331.434231238,9,1,9,10,19
Fiji,FJ,East Asia & Pacific,2022-07-22,passenger,696,647,3234,3881,4577,14626158.0660191,8,2,6,8,16
Fiji,FJ,East Asia & Pacific,2022-07-23,passenger,695,607,3517,4124,4819,16575131.267806033,7,2,9,11,18
Fiji,FJ,East Asia & Pacific,2022-07-24,passenger,671,817,2891,3708,4379,14602900.634983726,8,3,6,9,17
Fiji,FJ,East Asia & Pacific,2022-07-25,passenger,590,334,3695,4029,4619,14244885.67531357,7,1,11,12,19
Fiji,FJ,East Asia & Pacific,2022-07-26,passenger,589,334,2518,2852,3441,10056981.817847962,8,1,7,8,16
Fiji,FJ,East Asia & Pacific,2022-07-27,passenger,722,607,2826,3433,4155,13172074.319849381,8,2,6,8,16
Fiji,FJ,East Asia & Pacific,2022-07-28,passenger,685,334,2684,3018,3703,10557103.210027022,8,1,9,10,18
Fiji,FJ,East Asia & Pacific,2022-07-29,passenger,565,647,3322,3969,4534,14774784.694058709,8,2,7,9,17
Fiji,FJ,East Asia & Pacific,2022-07-30,passenger,608,607,3007,3614,4222,15446710.873078149,8,2,8,10,18
Fiji,FJ,East Asia & Pacific,2022-07-31,passenger,668,817,2958,3775,4443,14748158.215653805,7,3,6,9,16
Fiji,FJ,East Asia & Pacific,2022-08-01,passenger,700,334,4036,4370,5070,14940033.296836222,8,1,13,14,22
Fiji,FJ,East Asia & Pacific,2022-08-02,passenger,478,334,2594,2928,3406,10043964.313454803,6,1,7,8,14
Fiji,FJ,East Asia & Pacific,2022-08-03,passenger,467,607,2805,3412,3879,12751349.351631228,7,2,7,9,16
Fiji,FJ,East Asia & Pacific,2022-08-04,passenger,916,334,2589,2923,3839,10738736.941142704,12,1,8,9,21
Fiji,FJ,East Asia & Pacific,2022-08-05,passenger,695,647,3264,3911,4606,14894458.583915126,8,2,6,8,16
Fiji,FJ,East Asia & Pacific,2022-08-06,passenger,813,607,3381,3988,4801,16404070.073184693,7,2,9,11,18
Fiji,FJ,East Asia & Pacific,2022-08-07,passenger,802,647,2958,3605,4407,13860171.397374999,8,2,7,9,17
Fiji,FJ,East Asia & Pacific,2022-08-08,passenger,658,504,3701,4205,4863,14653927.691899486,7,2,11,13,20
Fiji,FJ,East Asia & Pacific,2022-08-09,passenger,783,334,2436,2770,3553,9727219.145002244,9,1,7,8,17
Fiji,FJ,East Asia & Pacific,2022-08-10,cargo,0,0,0,0,0,0,0,1,0,1,1
Fiji,FJ,East Asia & Pacific,2022-08-10,passenger,764,586,2594,3180,3944,12025375.441166842,7,2,7,9,16
Fiji,FJ,East Asia & Pacific,2022-08-11,passenger,832,668,2595,3263,4095,13875996.359204086,8,2,8,10,18
Fiji,FJ,East Asia & Pacific,2022-08-12,passenger,832,899,3093,3992,4824,16642130.127298879,9,2,6,8,17
Fiji,FJ,East Asia & Pacific,2022-08-13,passenger,764,334,3089,3423,4187,13076794.867784552,8,1,9,10,18
Fiji,FJ,East Asia & Pacific,2022-08-14,passenger,715,817,3126,3943,4658,14923654.729455005,8,3,8,11,19
Fiji,FJ,East Asia & Pacific,2022-08-15,passenger,647,334,3533,3867,4514,13921440.408282695,9,1,10,11,20
Fiji,FJ,East Asia & Pacific,2022-08-16,passenger,832,334,2594,2928,3760,10104610.271934174,8,1,7,8,16
Fiji,FJ,East Asia & Pacific,2022-08-17,passenger,745,334,2663,2997,3742,9890944.008070696,7,1,7,8,15
Fiji,FJ,East Asia & Pacific,2022-08-18,passenger,715,668,2697,3365,4080,13837135.648547856,13,1,9,10,23
Fiji,FJ,East Asia & Pacific,2022-08-19,passenger,745,920,3537,4457,5202,18212983.247674394,7,2,7,9,16
Fiji,FJ,East Asia & Pacific,2022-08-20,passenger,802,334,3211,3545,4347,13467738.699590994,9,1,9,10,19
Fiji,FJ,East Asia & Pacific,2022-08-21,passenger,696,817,3196,4013,4709,14988592.772252476,7,3,9,12,19
Fiji,FJ,East Asia & Pacific,2022-08-22,passenger,843,334,3743,4077,4920,14560585.391203744,7,1,10,11,18
Fiji,FJ,East Asia & Pacific,2022-08-23,passenger,745,334,2110,2444,3189,8918337.20918082,8,1,6,7,15
Fiji,FJ,East Asia & Pacific,2022-08-24,passenger,734,607,2710,3317,4051,13766309.46016479,7,2,8,10,17
Fiji,FJ,East Asia & Pacific,2022-08-25,passenger,802,334,2684,3018,3820,10860126.712598378,10,1,9,10,20
Fiji,FJ,East Asia & Pacific,2022-08-26,passenger,1014,607,3266,3873,4887,14444487.576078216,10,2,7,9,19
Fiji,FJ,East Asia & Pacific,2022-08-27,passenger,522,334,3595,3929,4451,14255292.257285263,6,1,10,11,17
Fiji,FJ,East Asia & Pacific,2022-08-28,passenger,647,756,3122,3878,4525,14681806.002336713,8,3,7,10,18
Fiji,FJ,East Asia & Pacific,2022-08-29,passenger,734,334,3571,3905,4639,13648758.76825948,9,1,11,12,21
Fiji,FJ,East Asia & Pacific,2022-08-30,passenger,896,273,2110,2383,3279,8367946.916460841,10,1,6,7,17
Fiji,FJ,East Asia & Pacific,2022-08-31,passenger,726,607,2537,3144,3870,12012060.88133235,8,2,7,9,17
Fiji,FJ,East Asia & Pacific,2022-09-01,passenger,658,313,2957,3270,3928,11465146.10251937,8,1,9,10,18
Fiji,FJ,East Asia & Pacific,2022-09-02,passenger,802,607,3289,3896,4698,14383274.94952029,8,2,7,9,17
Fiji,FJ,East Asia & Pacific,2022-09-03,passenger,696,313,3001,3314,4010,12688463.434107952,8,1,9,10,18
Fiji,FJ,East Asia & Pacific,2022-09-04,passenger,590,947,2935,3882,4472,14947214.615906866,6,3,8,11,17
Fiji,FJ,East Asia & Pacific,2022-09-05,passenger,628,626,3384,4010,4638,15685440.170328388,9,1,12,13,22
Fiji,FJ,East Asia & Pacific,2022-09-06,passenger,851,334,2667,3001,3852,10509830.729212316,10,1,7,8,18
Fiji,FJ,East Asia & Pacific,2022-09-07,cargo,0,0,0,0,0,0,0,0,1,1,1
Fiji,FJ,East Asia & Pacific,2022-09-07,passenger,628,546,2339,2885,3513,11053065.405554412,7,2,7,9,16
Fiji,FJ,East Asia & Pacific,2022-09-08,passenger,832,334,2747,3081,3913,10982688.598913934,9,1,8,9,18
Fiji,FJ,East Asia & Pacific,2022-09-09,passenger,832,586,2909,3495,4327,13393752.936178757,8,2,7,9,17
Fiji,FJ,East Asia & Pacific,2022-09-10,passenger,696,334,3261,3595,4291,12003603.063792065,7,1,8,9,16
Fiji,FJ,East Asia & Pacific,2022-09-11,passenger,753,756,3632,4388,5141,19254781.085244723,9,3,9,12,21
Fiji,FJ,East Asia & Pacific,2022-09-12,passenger,658,334,3298,3632,4290,12941436.70063162,6,1,11,12,18
Fiji,FJ,East Asia & Pacific,2022-09-13,passenger,677,273,2499,2772,3449,9380749.15799275,7,1,6,7,14
Fiji,FJ,East Asia & Pacific,2022-09-14,passenger,734,607,2679,3286,4020,12692612.881891774,8,2,7,9,17
Fiji,FJ,East Asia & Pacific,2022-09-15,passenger,764,334,2934,3268,4032,11410666.658611065,9,1,9,10,19
Fiji,FJ,East Asia & Pacific,2022-09-16,cargo,0,0,0,0,0,0,0,0,1,1,1
Fiji,FJ,East Asia & Pacific,2022-09-16,passenger,832,607,3451,4058,4890,15448593.73646114,9,2,8,10,19
Fiji,FJ,East Asia & Pacific,2022-09-17,passenger,783,334,3507,3841,4624,14298844.779472336,7,1,9,10,17
Fiji,FJ,East Asia & Pacific,2022-09-18,passenger,968,947,3481,4428,5396,16869372.210021462,8,3,7,10,18
Fiji,FJ,East Asia & Pacific,2022-09-19,passenger,628,334,3291,3625,4253,13698923.879440552,7,1,10,11,18
Fiji,FJ,East Asia & Pacific,2022-09-20,passenger,764,334,2602,2936,3700,10270905.03419509,7,1,6,7,14
Fiji,FJ,East Asia & Pacific,2022-09-21,passenger,628,607,2849,3456,4084,13084629.974067245,7,2,7,9,16
Fiji,FJ,East Asia & Pacific,2022-09-22,passenger,677,334,3263,3597,4274,12395081.35945484,9,1,9,10,19
Fiji,FJ,East Asia & Pacific,2022-09-23,passenger,590,607,3123,3730,4320,14042335.397873119,8,2,7,9,17
Fiji,FJ,East Asia & Pacific,2022-09-24,passenger,435,334,4375,4709,5144,16429795.660577267,7,1,9,10,17
Fiji,FJ,East Asia & Pacific,2022-09-25,passenger,715,777,3884,4661,5376,16726048.226455718,8,3,8,11,19
Fiji,FJ,East Asia & Pacific,2022-09-26,passenger,764,334,3165,3499,4263,13271547.94355438,8,1,10,11,19
Fiji,FJ,East Asia & Pacific,2022-09-27,passenger,794,334,2916,3250,4044,10625678.344307862,7,1,8,9,16
Fiji,FJ,East Asia & Pacific,2022-09-28,passenger,753,607,3099,3706,4459,13876758.26081481,9,2,7,9,18
Fiji,FJ,East Asia & Pacific,2022-09-29,passenger,832,334,3358,3692,4524,12569794.225102691,9,1,10,11,20
Fiji,FJ,East Asia & Pacific,2022-09-30,passenger,889,607,3669,4276,5165,15612271.152643055,9,2,7,9,18
Fiji,FJ,East Asia & Pacific,2022-10-01,passenger,598,334,4024,4358,4956,15158069.925117705,8,1,11,12,20
Fiji,FJ,East Asia & Pacific,2022-10-02,passenger,957,777,3435,4212,5169,15692722.241902757,9,3,7,10,19
Fiji,FJ,East Asia & Pacific,2022-10-03,passenger,794,334,3667,4001,4795,14471989.75455565,7,1,11,12,19
Fiji,FJ,East Asia & Pacific,2022-10-04,passenger,707,334,2857,3191,3898,10707585.715581369,7,1,7,8,15
Fiji,FJ,East Asia & Pacific,2022-10-05,passenger,1392,607,2826,3433,4825,13124130.473085953,13,2,7,9,22
Fiji,FJ,East Asia & Pacific,2022-10-06,passenger,1430,334,3204,3538,4968,12379650.50479881,15,1,10,11,26
Fiji,FJ,East Asia & Pacific,2022-10-07,passenger,1430,607,3539,4146,5576,15296168.920710452,13,2,7,9,22
Fiji,FJ,East Asia & Pacific,2022-10-08,passenger,1389,334,3237,3571,4960,13303939.643733095,13,1,10,11,24
Fiji,FJ,East Asia & Pacific,2022-10-09,passenger,1430,777,3231,4008,5438,15216748.651873475,10,3,8,11,21
Fiji,FJ,East Asia & Pacific,2022-10-10,passenger,1313,334,3329,3663,4976,13508800.008387033,16,1,11,12,28
Fiji,FJ,East Asia & Pacific,2022-10-11,passenger,1770,668,2786,3454,5224,13601398.777967896,16,1,7,8,24
Fiji,FJ,East Asia & Pacific,2022-10-12,passenger,1698,607,2460,3067,4765,12371604.255098578,13,2,8,10,23
Fiji,FJ,East Asia & Pacific,2022-10-13,passenger,1526,334,3513,3847,5373,12751723.412044888,14,1,11,12,26
Fiji,FJ,East Asia & Pacific,2022-10-14,passenger,1543,607,3476,4083,5626,15029242.630962687,14,2,7,9,23
Fiji,FJ,East Asia & Pacific,2022-10-15,passenger,1550,334,3713,4047,5597,14656340.137538156,12,1,10,11,23
Fiji,FJ,East Asia & Pacific,2022-10-16,passenger,1702,777,2681,3458,5160,13769504.411526281,11,3,6,9,20
Fiji,FJ,East Asia & Pacific,2022-10-17,passenger,1410,334,3356,3690,5100,13462686.901072739,14,1,10,11,25
Fiji,FJ,East Asia & Pacific,2022-10-18,passenger,1393,334,2539,2873,4266,10172653.435130648,15,1,6,7,22
Fiji,FJ,East Asia & Pacific,2022-10-19,passenger,1495,953,2384,3337,4832,16166180.689783398,17,3,7,10,27
Fiji,FJ,East Asia & Pacific,2022-10-20,passenger,1654,334,2671,3005,4659,10766001.715058468,16,1,9,10,26
Fiji,FJ,East Asia & Pacific,2022-10-21,passenger,1421,607,3071,3678,5099,14027586.349809136,12,2,5,7,19
Fiji,FJ,East Asia & Pacific,2022-10-22,passenger,1538,334,3202,3536,5074,13313879.936984142,13,1,9,10,23
Fiji,FJ,East Asia & Pacific,2022-10-23,passenger,1887,777,2511,3288,5175,13449235.65375796,11,3,6,9,20
Fiji,FJ,East Asia & Pacific,2022-10-24,passenger,1236,334,3186,3520,4756,13077152.710670246,15,1,10,11,26
Fiji,FJ,East Asia & Pacific,2022-10-25,passenger,1275,334,2579,2913,4188,10231016.857269356,15,1,6,7,22
Fiji,FJ,East Asia & Pacific,2022-10-26,passenger,1766,607,2446,3053,4819,12049960.862777932,15,2,7,9,24
Fiji,FJ,East Asia & Pacific,2022-10-27,passenger,1502,334,2671,3005,4507,10737066.514656214,15,1,9,10,25
Fiji,FJ,East Asia & Pacific,2022-10-28,passenger,1237,607,2589,3196,4433,12780760.3296234,11,2,5,7,18
Fiji,FJ,East Asia & Pacific,2022-10-29,passenger,949,334,3417,3751,4700,13600003.637926254,7,1,9,10,17
Fiji,FJ,East Asia & Pacific,2022-10-30,passenger,900,777,3031,3808,4708,16775294.491925426,9,3,7,10,19
Fiji,FJ,East Asia & Pacific,2022-10-31,passenger,957,334,3266,3600,4557,12959690.651013503,12,1,11,12,24
Fiji,FJ,East Asia & Pacific,2022-11-01,passenger,1585,334,2981,3315,4900,11198376.06106909,18,1,9,10,28
Fiji,FJ,East Asia & Pacific,2022-11-02,passenger,1373,607,2719,3326,4699,12719655.873207677,13,2,7,9,22
Fiji,FJ,East Asia & Pacific,2022-11-03,passenger,1510,334,2631,2965,4475,10529253.90618274,16,1,11,12,28
Fiji,FJ,East Asia & Pacific,2022-11-04,passenger,1326,607,2839,3446,4772,13496736.044530343,13,2,5,7,20
Fiji,FJ,East Asia & Pacific,2022-11-05,passenger,1481,334,3464,3798,5279,14151712.909522362,12,1,10,11,23
Fiji,FJ,East Asia & Pacific,2022-11-06,passenger,1849,777,2442,3219,5068,13464029.251003357,13,3,6,9,22
Fiji,FJ,East Asia & Pacific,2022-11-07,passenger,1286,334,3473,3807,5093,13543856.546609873,13,1,10,11,24
Fiji,FJ,East Asia & Pacific,2022-11-08,passenger,1528,334,2343,2677,4205,9865194.478585295,17,1,7,8,25
Fiji,FJ,East Asia & Pacific,2022-11-09,passenger,1438,586,2824,3410,4848,12710957.241741888,15,2,7,9,24
Fiji,FJ,East Asia & Pacific,2022-11-10,passenger,1483,334,2734,3068,4551,10855492.93659572,13,1,11,12,25
Fiji,FJ,East Asia & Pacific,2022-11-11,passenger,1430,586,2486,3072,4502,12349118.404719163,14,2,5,7,21
Fiji,FJ,East Asia & Pacific,2022-11-12,passenger,1528,334,3540,3874,5402,13784446.423534766,13,1,9,10,23
Fiji,FJ,East Asia & Pacific,2022-11-13,passenger,1751,756,2547,3303,5054,13475139.94176372,12,3,6,9,21
Fiji,FJ,East Asia & Pacific,2022-11-14,passenger,1324,334,2932,3266,4590,10562746.162796138,14,1,10,11,25
Fiji,FJ,East Asia & Pacific,2022-11-15,passenger,1392,273,3190,3463,4855,12582809.994342145,17,1,9,10,27
Fiji,FJ,East Asia & Pacific,2022-11-16,passenger,1441,607,2247,2854,4295,11606854.183928197,14,2,7,9,23
Fiji,FJ,East Asia & Pacific,2022-11-17,passenger,1628,313,3352,3665,5293,12159972.693858443,17,1,10,11,28
Fiji,FJ,East Asia & Pacific,2022-11-18,passenger,1483,607,2319,2926,4409,12078559.830777397,14,2,6,8,22
Fiji,FJ,East Asia & Pacific,2022-11-19,passenger,1286,313,3234,3547,4833,12958452.850189378,13,1,9,10,23
Fiji,FJ,East Asia & Pacific,2022-11-20,passenger,1561,777,3005,3782,5343,14516595.910971714,10,3,7,10,20
Fiji,FJ,East Asia & Pacific,2022-11-21,passenger,1042,273,3580,3853,4895,13336424.77317496,13,1,12,13,26
Fiji,FJ,East Asia & Pacific,2022-11-22,passenger,1233,334,2640,2974,4207,10322916.405989468,15,1,8,9,24
Fiji,FJ,East Asia & Pacific,2022-11-23,passenger,1242,586,2661,3247,4489,12582086.932113191,15,2,7,9,24
Fiji,FJ,East Asia & Pacific,2022-11-24,passenger,1540,334,3118,3452,4992,13539458.155376365,17,1,12,13,30
Fiji,FJ,East Asia & Pacific,2022-11-25,passenger,1459,586,2741,3327,4786,13103358.408590842,12,2,6,8,20
Fiji,FJ,East Asia & Pacific,2022-11-26,passenger,1324,607,3725,4332,5656,16852912.733065695,13,2,9,11,24
Fiji,FJ,East Asia & Pacific,2022-11-27,passenger,1667,817,2614,3431,5098,14267583.81534764,14,3,6,9,23
Fiji,FJ,East Asia & Pacific,2022-11-28,passenger,915,334,3539,3873,4788,13518879.307020012,12,1,12,13,25
Fiji,FJ,East Asia & Pacific,2022-11-29,passenger,1005,607,2625,3232,4237,12874345.693022666,15,2,8,10,25
Fiji,FJ,East Asia & Pacific,2022-11-30,passenger,1166,607,2546,3153,4319,12647543.866468472,13,2,7,9,22
Fiji,FJ,East Asia & Pacific,2022-12-01,passenger,1624,334,3844,4178,5802,13441971.685061164,18,1,11,12,30
Fiji,FJ,East Asia & Pacific,2022-12-02,passenger,1516,607,2890,3497,5013,13953924.455899298,15,2,6,8,23
Fiji,FJ,East Asia & Pacific,2022-12-03,passenger,1554,647,3048,3695,5249,15355802.133416355,16,2,8,10,26
Fiji,FJ,East Asia & Pacific,2022-12-04,passenger,1314,777,3478,4255,5569,15976515.765902953,12,3,8,11,23
Fiji,FJ,East Asia & Pacific,2022-12-05,passenger,1180,334,3609,3943,5123,13868860.997490715,17,1,12,13,30
Fiji,FJ,East Asia & Pacific,2022-12-06,passenger,1406,607,2653,3260,4666,12935636.974965705,20,2,9,11,31
Fiji,FJ,East Asia & Pacific,2022-12-07,passenger,1455,777,2793,3570,5025,14150032.358546382,18,3,7,10,28
Fiji,FJ,East Asia & Pacific,2022-12-08,passenger,1507,334,3625,3959,5466,12680728.490569865,18,1,12,13,31
Fiji,FJ,East Asia & Pacific,2022-12-09,passenger,1660,607,2625,3232,4892,12817848.255225897,15,2,6,8,23
Fiji,FJ,East Asia & Pacific,2022-12-10,passenger,1387,607,3580,4187,5574,14718517.755817128,14,2,8,10,24
Fiji,FJ,East Asia & Pacific,2022-12-11,passenger,1428,817,3891,4708,6136,18743400.77202232,14,3,10,13,27
Fiji,FJ,East Asia & Pacific,2022-12-12,passenger,1047,334,4122,4456,5503,14933350.76657812,13,1,12,13,26
Fiji,FJ,East Asia & Pacific,2022-12-13,passenger,1560,607,3661,4268,5828,14745942.563752318,20,2,11,13,33
Fiji,FJ,East Asia & Pacific,2022-12-14,passenger,1185,777,2766,3543,4728,13674100.858916705,14,3,8,11,25
Fiji,FJ,East Asia & Pacific,2022-12-15,passenger,1632,334,4192,4526,6158,15796724.697787104,17,1,13,14,31
Fiji,FJ,East Asia & Pacific,2022-12-16,passenger,1463,607,3783,4390,5853,15960063.262542628,15,2,7,9,24
Fiji,FJ,East Asia & Pacific,2022-12-17,passenger,1387,880,3645,4525,5912,19114350.28870676,13,3,10,13,26
Fiji,FJ,East Asia & Pacific,2022-12-18,passenger,1447,777,4449,5226,6673,18714044.963511232,12,3,8,11,23
Fiji,FJ,East Asia & Pacific,2022-12-19,passenger,1441,607,4027,4634,6075,17556717.607927393,15,2,12,14,29
Fiji,FJ,East Asia & Pacific,2022-12-20,passenger,1404,334,3628,3962,5366,12936122.671547292,19,1,10,11,30
Fiji,FJ,East Asia & Pacific,2022-12-21,passenger,1147,1050,3450,4500,5647,18081693.66414471,14,4,8,12,26
Fiji,FJ,East Asia & Pacific,2022-12-22,passenger,1499,607,4582,5189,6688,20037553.725895256,17,2,12,14,31
Fiji,FJ,East Asia & Pacific,2022-12-23,passenger,1403,607,3503,4110,5513,15258906.642630711,14,2,8,10,24
Fiji,FJ,East Asia & Pacific,2022-12-24,passenger,787,880,4113,4993,5780,20313507.612024076,8,3,11,14,22
Fiji,FJ,East Asia & Pacific,2022-12-25,passenger,828,777,3412,4189,5017,15695707.76403923,8,3,7,10,18
Fiji,FJ,East Asia & Pacific,2022-12-26,passenger,722,334,4066,4400,5122,15774466.148203954,7,1,10,11,18
Fiji,FJ,East Asia & Pacific,2022-12-27,passenger,595,607,3476,4083,4678,14570044.248629617,7,2,11,13,20
Fiji,FJ,East Asia & Pacific,2022-12-28,passenger,1359,777,3706,4483,5842,16950747.560470007,15,3,8,11,26
Fiji,FJ,East Asia & Pacific,2022-12-29,passenger,1586,607,4626,5233,6819,19743234.76307391,16,2,12,14,30
Fiji,FJ,East Asia & Pacific,2022-12-30,passenger,1400,607,3546,4153,5553,15428679.763297789,15,2,7,9,24
Fiji,FJ,East Asia & Pacific,2022-12-31,passenger,1297,880,3908,4788,6085,20129218.24664965,12,3,11,14,26
Fiji,FJ,East Asia & Pacific,2023-01-01,passenger,1819,777,3758,4535,6354,16927797.73417199,12,3,8,11,23
Fiji,FJ,East Asia & Pacific,2023-01-02,cargo,0,0,0,0,0,0,0,0,1,1,1
Fiji,FJ,East Asia & Pacific,2023-01-02,passenger,1041,334,4299,4633,5674,15733685.754753321,13,1,12,13,26
Fiji,FJ,East Asia & Pacific,2023-01-03,passenger,1419,607,3285,3892,5311,14623050.110355549,16,2,10,12,28
Fiji,FJ,East Asia & Pacific,2023-01-04,passenger,1699,777,3713,4490,6189,17994294.79186043,14,3,9,12,26
Fiji,FJ,East Asia & Pacific,2023-01-05,passenger,1719,334,4897,5231,6950,17943339.44878495,15,1,13,14,29
Fiji,FJ,East Asia & Pacific,2023-01-06,passenger,1430,607,3540,4147,5577,15743882.725180652,13,2,8,10,23
Fiji,FJ,East Asia & Pacific,2023-01-07,passenger,1479,880,3734,4614,6093,17906595.848916057,13,3,8,11,24
Fiji,FJ,East Asia & Pacific,2023-01-08,passenger,1754,777,3899,4676,6430,19363658.717319835,13,3,8,11,24
Fiji,FJ,East Asia & Pacific,2023-01-09,passenger,1231,607,4312,4919,6150,19528272.433853224,16,2,13,15,31
Fiji,FJ,East Asia & Pacific,2023-01-10,passenger,1392,607,3795,4402,5794,16016155.787360663,18,2,10,12,30
Fiji,FJ,East Asia & Pacific,2023-01-11,passenger,1858,777,3660,4437,6295,16286108.302252065,15,3,9,12,27
Fiji,FJ,East Asia & Pacific,2023-01-12,passenger,1787,334,4345,4679,6466,16682517.256993743,17,1,13,14,31
Fiji,FJ,East Asia & Pacific,2023-01-13,passenger,1308,607,3332,3939,5247,14942676.478388995,13,2,7,9,22
Fiji,FJ,East Asia & Pacific,2023-01-14,passenger,1525,880,4259,5139,6664,20637171.20497149,13,3,10,13,26
Fiji,FJ,East Asia & Pacific,2023-01-15,passenger,1727,777,3588,4365,6092,16408917.075034946,13,3,7,10,23
Fiji,FJ,East Asia & Pacific,2023-01-16,passenger,1248,334,4062,4396,5644,15204704.038056403,16,1,12,13,29
Fiji,FJ,East Asia & Pacific,2023-01-17,passenger,1622,607,3037,3644,5266,13936444.634295192,19,2,10,12,31
Fiji,FJ,East Asia & Pacific,2023-01-18,passenger,1631,777,3595,4372,6003,16202579.489881044,16,3,8,11,27
Fiji,FJ,East Asia & Pacific,2023-01-19,passenger,1844,334,3923,4257,6101,15244919.164469339,17,1,12,13,30
Fiji,FJ,East Asia & Pacific,2023-01-20,passenger,1333,607,3376,3983,5316,14889795.62237298,13,2,6,8,21
Fiji,FJ,East Asia & Pacific,2023-01-21,passenger,1588,607,3687,4294,5882,16934142.8182018,13,2,10,12,25
Fiji,FJ,East Asia & Pacific,2023-01-22,passenger,1689,777,3802,4579,6268,16690970.761836702,14,3,7,10,24
Fiji,FJ,East Asia & Pacific,2023-01-23,passenger,757,334,3959,4293,5050,13162702.138688818,12,1,11,12,24
Fiji,FJ,East Asia & Pacific,2023-01-24,passenger,872,607,3161,3768,4640,15662645.41813106,9,2,10,12,21
Fiji,FJ,East Asia & Pacific,2023-01-25,passenger,1593,777,3078,3855,5448,15260916.25347788,15,3,6,9,24
Fiji,FJ,East Asia & Pacific,2023-01-26,passenger,1814,334,4267,4601,6415,16022761.325107707,17,1,13,14,31
Fiji,FJ,East Asia & Pacific,2023-01-27,passenger,1390,607,2828,3435,4825,13629446.584319633,14,2,6,8,22
Fiji,FJ,East Asia & Pacific,2023-01-28,passenger,1479,607,3165,3772,5251,16103270.428316247,14,2,9,11,25
Fiji,FJ,East Asia & Pacific,2023-01-29,passenger,1572,979,3901,4880,6452,17900915.40393697,14,4,8,12,26
Fiji,FJ,East Asia & Pacific,2023-01-30,passenger,1258,334,3735,4069,5327,14072247.19916199,14,1,12,13,27
Fiji,FJ,East Asia & Pacific,2023-01-31,passenger,1542,882,3101,3983,5525,16994340.828902055,18,3,10,13,31
Fiji,FJ,East Asia & Pacific,2023-02-01,passenger,1574,777,2769,3546,5120,13817655.68674635,14,3,7,10,24
Fiji,FJ,East Asia & Pacific,2023-02-02,passenger,1795,334,3261,3595,5390,13604375.654378053,19,1,12,13,32
Fiji,FJ,East Asia & Pacific,2023-02-03,passenger,1260,607,3097,3704,4964,13880916.255542364,14,2,7,9,23
Fiji,FJ,East Asia & Pacific,2023-02-04,passenger,1604,607,3520,4127,5731,16403650.247292178,16,2,10,12,28
Fiji,FJ,East Asia & Pacific,2023-02-05,passenger,1697,777,2612,3389,5086,13647536.373650419,13,3,6,9,22
Fiji,FJ,East Asia & Pacific,2023-02-06,passenger,1234,334,3314,3648,4882,13048881.578231188,15,1,12,13,28
Fiji,FJ,East Asia & Pacific,2023-02-07,passenger,1357,607,2711,3318,4675,12892585.154635193,17,2,10,12,29
Fiji,FJ,East Asia & Pacific,2023-02-08,passenger,1468,777,2610,3387,4855,13274996.193703877,14,3,7,10,24
Fiji,FJ,East Asia & Pacific,2023-02-09,passenger,1825,334,3173,3507,5332,13256772.596537499,16,1,12,13,29
Fiji,FJ,East Asia & Pacific,2023-02-10,passenger,1584,607,2636,3243,4827,12749025.83755942,13,2,7,9,22
Fiji,FJ,East Asia & Pacific,2023-02-11,passenger,1403,607,3581,4188,5591,16497899.003847102,14,2,10,12,26
Fiji,FJ,East Asia & Pacific,2023-02-12,passenger,1765,777,2220,2997,4762,12704848.98453112,12,3,6,9,21
Fiji,FJ,East Asia & Pacific,2023-02-13,passenger,1272,668,2766,3434,4706,14839000.181217909,16,1,11,12,28
Fiji,FJ,East Asia & Pacific,2023-02-14,passenger,1300,607,2679,3286,4586,12690531.400652567,18,2,9,11,29
Fiji,FJ,East Asia & Pacific,2023-02-15,passenger,1506,777,2812,3589,5095,13713494.301186066,15,3,7,10,25
Fiji,FJ,East Asia & Pacific,2023-02-16,passenger,1714,334,3343,3677,5391,13715325.704685925,14,1,13,14,28
Fiji,FJ,East Asia & Pacific,2023-02-17,passenger,1531,607,2850,3457,4988,13232010.71106267,14,2,6,8,22
Fiji,FJ,East Asia & Pacific,2023-02-18,passenger,1520,607,3537,4144,5664,16274268.879123393,13,2,10,12,25
Fiji,FJ,East Asia & Pacific,2023-02-19,passenger,1842,777,2982,3759,5601,14366195.61544739,14,3,6,9,23
Fiji,FJ,East Asia & Pacific,2023-02-20,passenger,1461,334,3282,3616,5077,13028058.56007304,14,1,13,14,28
Fiji,FJ,East Asia & Pacific,2023-02-21,passenger,1327,607,2579,3186,4513,12561786.34884254,16,2,9,11,27
Fiji,FJ,East Asia & Pacific,2023-02-22,passenger,1446,777,2609,3386,4832,13175323.6917039,15,3,8,11,26
Fiji,FJ,East Asia & Pacific,2023-02-23,passenger,1703,334,3255,3589,5292,13613284.100768577,15,1,13,14,29
Fiji,FJ,East Asia & Pacific,2023-02-24,passenger,1576,607,3184,3791,5367,15611357.765676275,13,2,7,9,22
Fiji,FJ,East Asia & Pacific,2023-02-25,passenger,1523,607,3332,3939,5462,16158656.102050554,14,2,10,12,26
Fiji,FJ,East Asia & Pacific,2023-02-26,passenger,1697,777,2668,3445,5142,13577243.434299933,14,3,7,10,24
Fiji,FJ,East Asia & Pacific,2023-02-27,passenger,1090,334,3353,3687,4777,13184446.638956403,15,1,12,13,28
Fiji,FJ,East Asia & Pacific,2023-02-28,passenger,1319,607,2409,3016,4335,12023149.082696801,17,2,9,11,28
Fiji,FJ,East Asia & Pacific,2023-03-01,passenger,1506,777,2404,3181,4687,12969740.605190774,16,3,6,9,25
Fiji,FJ,East Asia & Pacific,2023-03-02,passenger,1825,334,2906,3240,5065,13027160.005939098,17,1,11,12,29
Fiji,FJ,East Asia & Pacific,2023-03-03,passenger,1265,607,3076,3683,4948,13861880.620139971,13,2,6,8,21
Fiji,FJ,East Asia & Pacific,2023-03-04,passenger,1468,607,3402,4009,5477,16635771.18655069,13,2,9,11,24
Fiji,FJ,East Asia & Pacific,2023-03-05,passenger,1651,777,2942,3719,5370,14292526.206863612,13,3,6,9,22
Fiji,FJ,East Asia & Pacific,2023-03-06,passenger,1090,334,3772,4106,5196,14647205.139804153,13,1,12,13,26
Fiji,FJ,East Asia & Pacific,2023-03-07,passenger,1450,607,2541,3148,4598,12575536.088514136,16,2,9,11,27
Fiji,FJ,East Asia & Pacific,2023-03-08,passenger,1324,777,3114,3891,5215,14296858.396565175,15,3,8,11,26
Fiji,FJ,East Asia & Pacific,2023-03-09,passenger,1689,334,3534,3868,5557,14382042.585374339,17,1,12,13,30
Fiji,FJ,East Asia & Pacific,2023-03-10,passenger,1437,607,2569,3176,4613,12584737.29711696,14,2,6,8,22
Fiji,FJ,East Asia & Pacific,2023-03-11,passenger,1422,607,3956,4563,5985,17365487.447963867,13,2,10,12,25
Fiji,FJ,East Asia & Pacific,2023-03-12,passenger,1651,777,2768,3545,5196,13996796.900740258,14,3,7,10,24
Fiji,FJ,East Asia & Pacific,2023-03-13,passenger,1212,334,3423,3757,4969,13393063.034515461,14,1,12,13,27
Fiji,FJ,East Asia & Pacific,2023-03-14,passenger,1241,607,2755,3362,4603,13028349.131002545,14,2,9,11,25
Fiji,FJ,East Asia & Pacific,2023-03-15,passenger,1558,777,2369,3146,4704,12771779.4226813,14,3,7,10,24
Fiji,FJ,East Asia & Pacific,2023-03-16,passenger,1847,334,3431,3765,5612,14111900.550431142,16,1,13,14,30
Fiji,FJ,East Asia & Pacific,2023-03-17,passenger,1352,607,2741,3348,4700,12942445.173230927,13,2,6,8,21
Fiji,FJ,East Asia & Pacific,2023-03-18,passenger,1460,607,3557,4164,5624,16856476.64143165,14,2,10,12,26
Fiji,FJ,East Asia & Pacific,2023-03-19,passenger,1697,777,2598,3375,5072,13524128.808991738,14,3,6,9,23
Fiji,FJ,East Asia & Pacific,2023-03-20,passenger,1109,334,3087,3421,4530,12905085.505821208,13,1,10,11,24
Fiji,FJ,East Asia & Pacific,2023-03-21,passenger,1262,607,2957,3564,4826,13748199.778661251,16,2,10,12,28
Fiji,FJ,East Asia & Pacific,2023-03-22,passenger,1496,777,2369,3146,4642,12755468.01708744,16,3,7,10,26
Fiji,FJ,East Asia & Pacific,2023-03-23,passenger,1730,334,3431,3765,5495,14078919.165751582,17,1,13,14,31
Fiji,FJ,East Asia & Pacific,2023-03-24,passenger,1379,607,2844,3451,4830,13185259.735691153,14,2,6,8,22
Fiji,FJ,East Asia & Pacific,2023-03-25,passenger,1425,607,3919,4526,5951,17166181.307014488,13,2,11,13,26
Fiji,FJ,East Asia & Pacific,2023-03-26,passenger,1724,1241,3068,4309,6033,18883671.314945657,14,4,7,11,25
Fiji,FJ,East Asia & Pacific,2023-03-27,passenger,1101,334,3255,3589,4690,13169100.317855896,14,1,12,13,27
Fiji,FJ,East Asia & Pacific,2023-03-28,passenger,1300,607,2755,3362,4662,13054618.978452632,16,2,9,11,27
Fiji,FJ,East Asia & Pacific,2023-03-29,passenger,1544,777,2574,3351,4895,13375657.247745818,16,3,7,10,26
Fiji,FJ,East Asia & Pacific,2023-03-30,passenger,1757,334,4056,4390,6147,15629851.396477222,17,1,13,14,31
Fiji,FJ,East Asia & Pacific,2023-03-31,passenger,1516,607,3036,3643,5159,13971541.682644136,14,2,6,8,22
Fiji,FJ,East Asia & Pacific,2023-04-01,passenger,1583,607,4047,4654,6237,19464052.942454726,13,2,13,15,28
Fiji,FJ,East Asia & Pacific,2023-04-02,passenger,1773,777,2994,3771,5544,14664334.475079931,13,3,6,9,22
Fiji,FJ,East Asia & Pacific,2023-04-03,passenger,1185,334,3970,4304,5489,16296290.051997488,15,1,13,14,29
Fiji,FJ,East Asia & Pacific,2023-04-04,passenger,1370,607,3622,4229,5599,16366300.096565112,17,2,10,12,29
Fiji,FJ,East Asia & Pacific,2023-04-05,passenger,1637,777,3074,3851,5488,14859137.690964933,15,3,7,10,25
Fiji,FJ,East Asia & Pacific,2023-04-06,passenger,1776,334,4361,4695,6471,14895452.699630614,16,1,12,13,29
Fiji,FJ,East Asia & Pacific,2023-04-07,passenger,1466,607,3924,4531,5997,17329098.180704318,12,2,7,9,21
Fiji,FJ,East Asia & Pacific,2023-04-08,passenger,1601,607,4448,5055,6656,20508204.62327724,14,2,13,15,29
Fiji,FJ,East Asia & Pacific,2023-04-09,passenger,1894,777,3124,3901,5795,15369196.193074323,12,3,6,9,21
Fiji,FJ,East Asia & Pacific,2023-04-10,passenger,1421,334,3970,4304,5725,16339536.517761296,15,1,13,14,29
Fiji,FJ,East Asia & Pacific,2023-04-11,passenger,1338,607,3452,4059,5397,16000945.663187424,18,2,10,12,30
Fiji,FJ,East Asia & Pacific,2023-04-12,passenger,1732,777,3054,3831,5563,14763399.804404613,15,3,8,11,26
Fiji,FJ,East Asia & Pacific,2023-04-13,passenger,1762,607,3749,4356,6118,15550507.706558492,17,2,12,14,31
Fiji,FJ,East Asia & Pacific,2023-04-14,passenger,1534,607,4067,4674,6208,18000121.972046964,14,2,8,10,24
Fiji,FJ,East Asia & Pacific,2023-04-15,passenger,1582,607,4304,4911,6493,20202473.02804686,14,2,12,14,28
Fiji,FJ,East Asia & Pacific,2023-04-16,passenger,1784,777,3443,4220,6004,16475502.529897576,15,3,7,10,25
Fiji,FJ,East Asia & Pacific,2023-04-17,passenger,1166,334,4070,4404,5570,16756659.838066898,14,1,13,14,28
Fiji,FJ,East Asia & Pacific,2023-04-18,passenger,1351,607,3786,4393,5744,17048762.89195788,15,2,10,12,27
Fiji,FJ,East Asia & Pacific,2023-04-19,passenger,1645,777,2884,3661,5306,14203760.522787467,15,3,8,11,26
Fiji,FJ,East Asia & Pacific,2023-04-20,passenger,1825,607,3789,4396,6221,15656355.168928802,19,2,12,14,33
Fiji,FJ,East Asia & Pacific,2023-04-21,passenger,1409,607,3754,4361,5770,16907202.85038402,15,2,8,10,25
Fiji,FJ,East Asia & Pacific,2023-04-22,passenger,1544,607,4442,5049,6593,20635875.79621216,17,2,13,15,32
Fiji,FJ,East Asia & Pacific,2023-04-23,passenger,1651,777,3735,4512,6163,16977899.29085138,14,3,8,11,25
Fiji,FJ,East Asia & Pacific,2023-04-24,passenger,1212,334,3898,4232,5444,16161433.040846484,15,1,12,13,28
Fiji,FJ,East Asia & Pacific,2023-04-25,passenger,1300,941,3025,3966,5266,17856879.686273362,17,2,10,12,29
Fiji,FJ,East Asia & Pacific,2023-04-26,passenger,1504,777,2810,3587,5091,14153734.255410442,15,3,7,10,25
Fiji,FJ,East Asia & Pacific,2023-04-27,passenger,1673,607,3916,4523,6196,17262433.345357638,15,2,13,15,30
Fiji,FJ,East Asia & Pacific,2023-04-28,passenger,1455,607,3924,4531,5986,17590089.037681025,15,2,8,10,25
Fiji,FJ,East Asia & Pacific,2023-04-29,passenger,1479,607,4050,4657,6136,17562609.120336466,14,2,11,13,27
Fiji,FJ,East Asia & Pacific,2023-04-30,passenger,1743,777,2784,3561,5304,14391806.52134445,14,3,7,10,24
Fiji,FJ,East Asia & Pacific,2023-05-01,passenger,1147,334,3797,4131,5278,15823660.452690324,14,1,13,14,28
Fiji,FJ,East Asia & Pacific,2023-05-02,passenger,1224,607,3267,3874,5098,15500883.017417938,14,2,11,13,27
Fiji,FJ,East Asia & Pacific,2023-05-03,passenger,1629,941,2939,3880,5509,16484649.34560407,14,2,9,11,25
Fiji,FJ,East Asia & Pacific,2023-05-04,passenger,1670,334,3536,3870,5540,13754048.490015721,16,1,12,13,29
Fiji,FJ,East Asia & Pacific,2023-05-05,passenger,1546,607,3464,4071,5617,16392170.469274526,14,2,8,10,24
Fiji,FJ,East Asia & Pacific,2023-05-06,passenger,1741,607,3675,4282,6023,17019156.281273946,14,2,11,13,27
Fiji,FJ,East Asia & Pacific,2023-05-07,passenger,1686,1111,2608,3719,5405,16847758.160998054,13,3,6,9,22
Fiji,FJ,East Asia & Pacific,2023-05-08,passenger,1196,334,3793,4127,5323,15428564.946307175,14,1,13,14,28
Fiji,FJ,East Asia & Pacific,2023-05-09,passenger,1319,607,3258,3865,5184,15570372.873757927,20,2,10,12,32
Fiji,FJ,East Asia & Pacific,2023-05-10,passenger,1531,607,2837,3444,4975,13419759.948906757,14,2,9,11,25
Fiji,FJ,East Asia & Pacific,2023-05-11,passenger,1613,334,3467,3801,5414,13422392.928864922,15,1,12,13,28
Fiji,FJ,East Asia & Pacific,2023-05-12,passenger,1469,607,3504,4111,5580,16484152.179999534,15,2,8,10,25
Fiji,FJ,East Asia & Pacific,2023-05-13,passenger,1460,941,3405,4346,5806,19099286.057283405,14,2,11,13,27
Fiji,FJ,East Asia & Pacific,2023-05-14,passenger,1667,777,2952,3729,5396,14649355.355257554,13,3,7,10,23
Fiji,FJ,East Asia & Pacific,2023-05-15,passenger,1188,334,3289,3623,4811,14696597.364094313,16,1,12,13,29
Fiji,FJ,East Asia & Pacific,2023-05-16,passenger,1235,607,3531,4138,5373,16252721.878145453,16,2,10,12,28
Fiji,FJ,East Asia & Pacific,2023-05-17,passenger,1772,607,2939,3546,5318,13524739.560883056,16,2,9,11,27
Fiji,FJ,East Asia & Pacific,2023-05-18,passenger,1616,334,3597,3931,5547,13870759.63344497,14,1,12,13,27
Fiji,FJ,East Asia & Pacific,2023-05-19,passenger,1409,607,3362,3969,5378,15894340.01835699,15,2,9,11,26
Fiji,FJ,East Asia & Pacific,2023-05-20,passenger,1460,607,3643,4250,5710,16548449.354140507,13,2,12,14,27
Fiji,FJ,East Asia & Pacific,2023-05-21,passenger,1724,777,2952,3729,5453,14484815.564393777,11,3,7,10,21
Fiji,FJ,East Asia & Pacific,2023-05-22,passenger,1139,334,3869,4203,5342,16114250.9266646,14,1,13,14,28
Fiji,FJ,East Asia & Pacific,2023-05-23,passenger,1306,607,3191,3798,5104,15431018.902539704,18,2,10,12,30
Fiji,FJ,East Asia & Pacific,2023-05-24,passenger,1512,607,3177,3784,5296,13980406.99166829,15,2,10,12,27
Fiji,FJ,East Asia & Pacific,2023-05-25,passenger,1757,334,3597,3931,5688,13903992.838896694,16,1,12,13,29
Fiji,FJ,East Asia & Pacific,2023-05-26,passenger,1620,607,3294,3901,5521,15844708.866980594,13,2,8,10,23
Fiji,FJ,East Asia & Pacific,2023-05-27,passenger,1517,607,3643,4250,5767,16558635.636487622,14,2,12,14,28
Fiji,FJ,East Asia & Pacific,2023-05-28,passenger,1721,777,2952,3729,5450,14505625.324776035,13,3,7,10,23
Fiji,FJ,East Asia & Pacific,2023-05-29,passenger,1158,334,3842,4176,5334,16046836.590166813,15,1,13,14,29
Fiji,FJ,East Asia & Pacific,2023-05-30,passenger,1295,607,3150,3757,5052,15260688.15265448,17,2,10,12,29
Fiji,FJ,East Asia & Pacific,2023-05-31,passenger,1566,607,3401,4008,5574,16143381.470559558,13,2,11,13,26
Fiji,FJ,East Asia & Pacific,2023-06-01,passenger,1635,334,3767,4101,5736,13003706.586729957,16,1,12,13,29
Fiji,FJ,East Asia & Pacific,2023-06-02,passenger,1543,607,3567,4174,5717,16401294.056728449,14,2,8,10,24
Fiji,FJ,East Asia & Pacific,2023-06-03,passenger,1668,607,4037,4644,6312,19727312.394922767,13,2,13,15,28
Fiji,FJ,East Asia & Pacific,2023-06-04,passenger,1907,777,3165,3942,5849,15121018.407743797,14,3,7,10,24
Fiji,FJ,East Asia & Pacific,2023-06-05,passenger,1468,668,4043,4711,6179,19456235.881945547,15,1,14,15,30
Fiji,FJ,East Asia & Pacific,2023-06-06,passenger,1511,607,3786,4393,5904,16530360.178629711,16,2,11,13,29
Fiji,FJ,East Asia & Pacific,2023-06-07,passenger,1501,607,3347,3954,5455,14553858.843103174,16,2,10,12,28
Fiji,FJ,East Asia & Pacific,2023-06-08,passenger,1969,334,3957,4291,6260,15403176.053968677,14,1,13,14,28
Fiji,FJ,East Asia & Pacific,2023-06-09,passenger,1404,607,3908,4515,5919,17328430.277243678,12,2,9,11,23
Fiji,FJ,East Asia & Pacific,2023-06-10,passenger,1683,607,4043,4650,6333,19341111.5021548,13,2,13,15,28
Fiji,FJ,East Asia & Pacific,2023-06-11,passenger,1561,777,3437,4214,5775,15810571.9850166,11,3,7,10,21
Fiji,FJ,East Asia & Pacific,2023-06-12,passenger,1337,334,3873,4207,5544,16282770.374797458,15,1,14,15,30
Fiji,FJ,East Asia & Pacific,2023-06-13,passenger,1428,607,4042,4649,6077,16087209.540830819,16,2,11,13,29
Fiji,FJ,East Asia & Pacific,2023-06-14,passenger,1438,607,3007,3614,5052,13568929.487105496,14,2,10,12,26
Fiji,FJ,East Asia & Pacific,2023-06-15,passenger,1638,334,4346,4680,6318,17535754.374469895,15,1,14,15,30
Fiji,FJ,East Asia & Pacific,2023-06-16,passenger,1521,607,4078,4685,6206,17811776.986638926,12,2,9,11,23
Fiji,FJ,East Asia & Pacific,2023-06-17,passenger,1626,607,4596,5203,6829,20982726.09816317,13,2,13,15,28
Fiji,FJ,East Asia & Pacific,2023-06-18,passenger,1743,777,3444,4221,5964,15567521.027786192,14,3,8,11,25
Fiji,FJ,East Asia & Pacific,2023-06-19,passenger,1292,334,4259,4593,5885,17420707.85602282,15,1,13,14,29
Fiji,FJ,East Asia & Pacific,2023-06-20,passenger,1447,607,4386,4993,6440,18007492.98004939,15,2,12,14,29
Fiji,FJ,East Asia & Pacific,2023-06-21,passenger,1566,607,3353,3960,5526,14901648.284908291,16,2,10,12,28
Fiji,FJ,East Asia & Pacific,2023-06-22,passenger,1583,607,4051,4658,6241,18080487.07129573,14,2,13,15,29
Fiji,FJ,East Asia & Pacific,2023-06-23,passenger,1589,607,4421,5028,6617,18624381.13867977,14,2,8,10,24
Fiji,FJ,East Asia & Pacific,2023-06-24,passenger,1599,607,4838,5445,7044,21735983.081283703,13,2,13,15,28
Fiji,FJ,East Asia & Pacific,2023-06-25,passenger,1618,777,3985,4762,6380,17477233.346485697,12,3,9,12,24
Fiji,FJ,East Asia & Pacific,2023-06-26,passenger,695,334,4386,4720,5415,17713708.388968565,8,1,13,14,22
Fiji,FJ,East Asia & Pacific,2023-06-27,passenger,1336,607,4002,4609,5945,16986574.107539643,15,2,12,14,29
Fiji,FJ,East Asia & Pacific,2023-06-28,passenger,1550,607,3380,3987,5537,14954800.695575211,14,2,10,12,26
Fiji,FJ,East Asia & Pacific,2023-06-29,passenger,1450,777,4519,5296,6746,19982233.190174703,14,3,13,16,30
Fiji,FJ,East Asia & Pacific,2023-06-30,passenger,1586,607,4345,4952,6538,18446502.00543147,15,2,8,10,25
Fiji,FJ,East Asia & Pacific,2023-07-01,passenger,1710,647,4968,5615,7325,22179946.850499634,14,2,13,15,29
Fiji,FJ,East Asia & Pacific,2023-07-02,passenger,1906,1111,3849,4960,6866,19999796.17548961,14,3,8,11,25
Fiji,FJ,East Asia & Pacific,2023-07-03,passenger,1466,334,4108,4442,5908,16746752.080105504,14,1,13,14,28
Fiji,FJ,East Asia & Pacific,2023-07-04,passenger,1531,607,4336,4943,6474,18336037.240592357,17,2,13,15,32
Fiji,FJ,East Asia & Pacific,2023-07-05,passenger,1634,607,3658,4265,5899,15053098.382524371,15,2,11,13,28
Fiji,FJ,East Asia & Pacific,2023-07-06,passenger,1842,607,4403,5010,6852,18999742.68582098,17,2,13,15,32
Fiji,FJ,East Asia & Pacific,2023-07-07,passenger,1594,607,4448,5055,6649,18787240.37899564,14,2,8,10,24
Fiji,FJ,East Asia & Pacific,2023-07-08,passenger,1599,607,4905,5512,7111,21871360.810270205,13,2,13,15,28
Fiji,FJ,East Asia & Pacific,2023-07-09,passenger,1800,607,4025,4632,6432,16441398.84996808,12,2,8,10,22
Fiji,FJ,East Asia & Pacific,2023-07-10,passenger,1515,334,4278,4612,6127,17175021.734674864,16,1,13,14,30
Fiji,FJ,East Asia & Pacific,2023-07-11,passenger,1417,607,4156,4763,6180,17748965.0080917,15,2,13,15,30
Fiji,FJ,East Asia & Pacific,2023-07-12,passenger,1626,607,3406,4013,5639,14769259.287057402,14,2,12,14,28
Fiji,FJ,East Asia & Pacific,2023-07-13,passenger,1765,607,4300,4907,6672,18610111.144645687,15,2,13,15,30
Fiji,FJ,East Asia & Pacific,2023-07-14,passenger,1559,607,4306,4913,6472,18212854.112582717,13,2,8,10,23
Fiji,FJ,East Asia & Pacific,2023-07-15,passenger,1721,334,5008,5342,7063,19544640.272775404,12,1,13,14,26
Fiji,FJ,East Asia & Pacific,2023-07-16,passenger,1640,777,3375,4152,5792,15797105.699170683,11,3,7,10,21
Fiji,FJ,East Asia & Pacific,2023-07-17,passenger,1452,607,4392,4999,6451,19647218.81261869,14,2,14,16,30
Fiji,FJ,East Asia & Pacific,2023-07-18,passenger,1493,607,4268,4875,6368,18098656.08824409,15,2,12,14,29
Fiji,FJ,East Asia & Pacific,2023-07-19,passenger,1262,607,3652,4259,5521,15300412.109980423,14,2,11,13,27
Fiji,FJ,East Asia & Pacific,2023-07-20,passenger,1995,607,4261,4868,6863,18442048.45996423,20,2,12,14,34
Fiji,FJ,East Asia & Pacific,2023-07-21,passenger,1847,607,4585,5192,7039,19143185.506829824,13,2,10,12,25
Fiji,FJ,East Asia & Pacific,2023-07-22,passenger,1816,607,4572,5179,6995,20710483.680232365,14,2,13,15,29
Fiji,FJ,East Asia & Pacific,2023-07-23,passenger,2000,1111,3578,4689,6689,19151752.066064626,15,3,8,11,26
Fiji,FJ,East Asia & Pacific,2023-07-24,passenger,1413,334,4618,4952,6365,17513426.328707602,15,1,13,14,29
Fiji,FJ,East Asia & Pacific,2023-07-25,passenger,1561,607,4098,4705,6266,17979048.89029745,15,2,12,14,29
Fiji,FJ,East Asia & Pacific,2023-07-26,passenger,1711,607,3653,4260,5971,15693218.682212066,15,2,11,13,28
Fiji,FJ,East Asia & Pacific,2023-07-27,passenger,1586,607,4397,5004,6590,18526119.31956188,13,2,14,16,29
Fiji,FJ,East Asia & Pacific,2023-07-28,passenger,1130,607,4415,5022,6152,18497053.44764597,11,2,10,12,23
Fiji,FJ,East Asia & Pacific,2023-07-29,passenger,997,607,4320,4927,5924,20196976.0798704,8,2,12,14,22
Fiji,FJ,East Asia & Pacific,2023-07-30,passenger,1032,777,3710,4487,5519,16392842.977414185,12,3,7,10,22
Fiji,FJ,East Asia & Pacific,2023-07-31,passenger,1371,668,4616,5284,6655,20712050.24460205,14,1,15,16,30
Fiji,FJ,East Asia & Pacific,2023-08-01,passenger,1485,607,3435,4042,5527,15924589.588445228,16,2,12,14,30
Fiji,FJ,East Asia & Pacific,2023-08-02,passenger,1591,647,3198,3845,5436,14212820.14718673,17,2,11,13,30
Fiji,FJ,East Asia & Pacific,2023-08-03,passenger,1661,607,4227,4834,6495,19808415.982997634,15,2,13,15,30
Fiji,FJ,East Asia & Pacific,2023-08-04,passenger,1602,607,3956,4563,6165,17233558.431071315,14,2,9,11,25
Fiji,FJ,East Asia & Pacific,2023-08-05,passenger,1474,607,4198,4805,6279,19746970.244584315,13,2,13,15,28
Fiji,FJ,East Asia & Pacific,2023-08-06,passenger,1705,777,3044,3821,5526,14536818.150333963,12,3,9,12,24
Fiji,FJ,East Asia & Pacific,2023-08-07,passenger,1353,334,3938,4272,5625,16147122.316663569,11,1,14,15,26
Fiji,FJ,East Asia & Pacific,2023-08-08,passenger,1455,607,3632,4239,5694,16157411.777874198,14,2,13,15,29
Fiji,FJ,East Asia & Pacific,2023-08-09,passenger,1531,607,3109,3716,5247,14096751.181280943,15,2,10,12,27
Fiji,FJ,East Asia & Pacific,2023-08-10,passenger,1784,607,4526,5133,6917,20891626.34960891,16,2,13,15,31
Fiji,FJ,East Asia & Pacific,2023-08-11,passenger,1567,607,3746,4353,5920,16614566.898677703,14,2,9,11,25
Fiji,FJ,East Asia & Pacific,2023-08-12,passenger,1496,607,4460,5067,6563,20199482.652766276,13,2,13,15,28
Fiji,FJ,East Asia & Pacific,2023-08-13,passenger,1754,777,2901,3678,5432,14108398.774365459,14,3,8,11,25
Fiji,FJ,East Asia & Pacific,2023-08-14,passenger,1208,334,3938,4272,5480,16128498.362559536,15,1,14,15,30
Fiji,FJ,East Asia & Pacific,2023-08-15,passenger,1602,1275,3537,4812,6414,22185420.526716456,19,2,13,15,34
Fiji,FJ,East Asia & Pacific,2023-08-16,passenger,1588,607,3198,3805,5393,14562628.974222777,15,2,10,12,27
Fiji,FJ,East Asia & Pacific,2023-08-17,passenger,1454,607,4390,4997,6451,20681401.25909474,15,2,13,15,30
Fiji,FJ,East Asia & Pacific,2023-08-18,passenger,1714,607,3505,4112,5826,16246995.727946052,13,2,9,11,24
Fiji,FJ,East Asia & Pacific,2023-08-19,passenger,1667,668,4425,5093,6760,20504699.98496012,14,2,13,15,29
Fiji,FJ,East Asia & Pacific,2023-08-20,passenger,1792,777,3478,4255,6047,15230199.372657938,14,3,9,12,26
Fiji,FJ,East Asia & Pacific,2023-08-21,passenger,1311,334,5073,5407,6718,19640436.84671915,15,1,13,14,29
